Rk,Player,Nation,Pos,Squad,Comp,Age,Born,90s,Tkl,TklW,Def 3rd,Mid 3rd,Att 3rd,Tkl,Att,Tkl%,Lost,Blocks,Sh,Pass,Int,Tkl+Int,Clr,Err,Matches
1,Max Aarons,eng ENG,DF,Bournemouth,eng Premier League,24-030,2000,12.1,28,18,20,6,2,19,30,63.3,11,9,5,4,6,34,23,0,Matches
2,Brenden Aaronson,us USA,MF,Union Berlin,de Bundesliga,23-104,2000,4.6,10,7,3,5,2,6,10,60,4,11,0,11,0,10,3,0,Matches
3,Paxten Aaronson,us USA,MF,Eint Frankfurt,de Bundesliga,20-161,2003,1.1,2,2,1,1,0,1,1,100,0,2,0,2,0,2,0,0,Matches
4,Yunis Abdelhamid,ma MAR,DF,Reims,fr Ligue 1,36-128,1987,16,34,21,17,15,2,13,25,52,12,26,17,9,19,53,50,0,Matches
5,Salis Abdul Samed,gh GHA,MF,Lens,fr Ligue 1,23-314,2000,13.9,17,12,6,8,3,5,12,41.7,7,9,0,9,9,26,11,0,Matches
6,Laurent Abergel,fr FRA,MF,Lorient,fr Ligue 1,31-002,1993,19,53,28,25,23,5,24,65,36.9,41,21,5,16,39,92,29,1,Matches
7,Matthis Abline,fr FRA,FW,Nantes,fr Ligue 1,20-312,2003,4.7,1,1,0,1,0,1,2,50,1,1,0,1,0,1,3,0,Matches
8,Abner,br BRA,DF,Betis,es La Liga,23-252,2000,12.8,20,17,12,7,1,14,27,51.9,13,21,4,17,11,31,51,0,Matches
9,Zakaria Aboukhlal,ma MAR,"MF,FW",Toulouse,fr Ligue 1,23-350,2000,4.2,1,1,0,0,1,1,3,33.3,2,3,0,3,1,2,1,0,Matches
10,Abdel Abqar,ma MAR,DF,Alavés,es La Liga,24-330,1999,13.9,16,8,13,1,2,10,18,55.6,8,14,10,4,12,28,69,0,Matches
11,Francesco Acerbi,it ITA,DF,Inter,it Serie A,35-358,1988,16.6,18,11,14,4,0,9,12,75,3,9,7,2,23,41,44,0,Matches
12,Marcos Acuña,ar ARG,DF,Sevilla,es La Liga,32-098,1991,5.7,13,9,9,4,0,5,6,83.3,1,5,1,4,4,17,8,0,Matches
13,Bénie Adama Traore,ci CIV,"FW,MF",Sheffield Utd,eng Premier League,21-065,2002,4.3,4,2,1,2,1,0,4,0,4,4,1,3,1,5,1,0,Matches
14,Bénie Adama Traore,ci CIV,FW,Nantes,fr Ligue 1,21-065,2002,0.8,1,0,0,1,0,0,0,,0,0,0,0,0,1,0,0,Matches
15,Akor Adams,ng NGA,FW,Montpellier,fr Ligue 1,24-005,2000,17,9,4,3,2,4,3,7,42.9,4,4,1,3,4,13,5,0,Matches
16,Junior Adamu,at AUT,"FW,MF",Freiburg,de Bundesliga,22-242,2001,1.1,5,1,1,2,2,1,2,50,1,1,0,1,0,5,1,0,Matches
17,Sargis Adamyan,am ARM,"FW,MF",Köln,de Bundesliga,30-256,1993,1.6,3,2,0,2,1,1,2,50,1,2,0,2,0,3,2,0,Matches
18,Tosin Adarabioyo,eng ENG,DF,Fulham,eng Premier League,26-132,1997,8,9,5,5,4,0,8,12,66.7,4,10,8,2,14,23,42,0,Matches
19,Elijah Adebayo,eng ENG,FW,Luton Town,eng Premier League,26-027,1998,10.9,1,0,1,0,0,0,6,0,6,8,1,7,4,5,17,0,Matches
20,Karim Adeyemi,de GER,"FW,MF",Dortmund,de Bundesliga,22-016,2002,4.1,7,7,3,2,2,3,10,30,7,6,0,6,2,9,1,0,Matches
21,Simon Adingra,ci CIV,"FW,MF",Brighton,eng Premier League,22-033,2002,12.7,20,11,11,5,4,10,24,41.7,14,12,0,12,12,32,9,0,Matches
22,Nathaniel Adjei,gh GHA,DF,Lorient,fr Ligue 1,21-166,2002,0.1,0,0,0,0,0,0,0,,0,0,0,0,1,1,0,0,Matches
23,Amine Adli,ma MAR,"MF,DF",Leverkusen,de Bundesliga,23-269,2000,2.9,6,1,1,2,3,4,6,66.7,2,5,1,4,3,9,1,0,Matches
24,Yacine Adli,fr FRA,MF,Milan,it Serie A,23-189,2000,7.5,24,13,12,9,3,10,25,40,15,8,5,3,12,36,11,0,Matches
25,Adryelson,br BRA,FW,Lyon,fr Ligue 1,25-317,1998,0,0,0,0,0,0,0,0,,0,0,0,0,1,1,0,0,Matches
26,Adson,br BRA,"MF,FW",Nantes,fr Ligue 1,23-120,2000,2.6,7,6,1,6,0,2,2,100,0,5,0,5,2,9,2,0,Matches
27,Michel Aebischer,ch SUI,MF,Bologna,it Serie A,27-028,1997,14.5,18,14,4,13,1,7,19,36.8,12,18,3,15,9,27,12,0,Matches
28,Emmanuel Agbadou,ci CIV,DF,Reims,fr Ligue 1,26-231,1997,14.6,33,20,15,16,2,23,35,65.7,12,19,7,12,31,64,58,1,Matches
29,Lucien Agoume,fr FRA,MF,Inter,it Serie A,21-359,2002,0.1,0,0,0,0,0,0,0,,0,0,0,0,0,0,0,0,Matches
30,Lucien Agoume,fr FRA,MF,Sevilla,es La Liga,21-359,2002,0.8,1,1,0,1,0,1,1,100,0,1,0,1,0,1,0,0,Matches
31,Felix Agu,de GER,"DF,MF",Werder Bremen,de Bundesliga,24-129,1999,5,11,8,7,3,1,6,8,75,2,1,0,1,3,14,11,0,Matches
32,Nayef Aguerd,ma MAR,DF,West Ham,eng Premier League,27-310,1996,15.7,19,8,13,6,0,11,13,84.6,2,23,17,6,16,35,70,2,Matches
33,Ruben Aguilar,fr FRA,DF,Lens,fr Ligue 1,30-283,1993,12.5,25,16,13,10,2,11,22,50,11,19,2,17,16,41,24,0,Matches
34,Brandon Aguilera,cr CRC,FW,Nott'ham Forest,eng Premier League,20-220,2003,0.1,0,0,0,0,0,0,0,,0,0,0,0,0,0,0,0,Matches
35,Naouirou Ahamada,fr FRA,"MF,FW",Crystal Palace,eng Premier League,21-311,2002,1.6,3,2,2,1,0,3,7,42.9,4,0,0,0,1,4,2,0,Matches
36,Anel Ahmedhodžić,ba BIH,DF,Sheffield Utd,eng Premier League,24-314,1999,15.5,37,26,28,7,2,16,28,57.1,12,25,14,11,19,56,63,0,Matches
37,Joseph Aidoo,gh GHA,DF,Celta Vigo,es La Liga,28-127,1995,4.5,8,3,6,2,0,4,8,50,4,3,1,2,4,12,28,0,Matches
38,Ola Aina,ng NGA,DF,Nott'ham Forest,eng Premier League,27-118,1996,11,26,15,21,4,1,17,23,73.9,6,10,3,7,8,34,38,1,Matches
39,Rayan Aït Nouri,dz ALG,"DF,MF",Wolves,eng Premier League,22-242,2001,13.1,37,22,19,14,4,12,18,66.7,6,16,5,11,11,48,25,0,Matches
40,Tosin Aiyegun,bj BEN,"MF,FW",Lorient,fr Ligue 1,25-222,1998,7.4,5,4,1,3,1,2,5,40,3,2,1,1,1,6,7,0,Matches
41,Kristoffer Ajer,no NOR,DF,Brentford,eng Premier League,25-292,1998,8.2,19,10,12,6,1,14,20,70,6,7,1,6,6,25,26,0,Matches
42,Ludovic Ajorque,fr FRA,FW,Mainz 05,de Bundesliga,29-343,1994,9.9,2,2,1,1,0,1,6,16.7,5,5,1,4,0,2,4,0,Matches
43,Manuel Akanji,ch SUI,"DF,MF",Manchester City,eng Premier League,28-199,1995,14,19,10,8,8,3,9,19,47.4,10,14,7,7,11,30,39,1,Matches
44,Marley Aké,fr FRA,FW,Udinese,it Serie A,23-029,2001,0.1,0,0,0,0,0,0,0,,0,0,0,0,0,0,0,0,Matches
45,Nathan Aké,nl NED,DF,Manchester City,eng Premier League,28-350,1995,13.2,16,8,12,4,0,8,12,66.7,4,8,0,8,7,23,30,0,Matches
46,Ilias Akhomach,es ESP,"MF,FW",Villarreal,es La Liga,19-293,2004,9.6,22,16,8,10,4,6,11,54.5,5,7,2,5,8,30,8,0,Matches
47,Sergio Akieme,es ESP,DF,Almería,es La Liga,26-049,1997,18.6,27,15,18,7,2,13,16,81.3,3,14,4,10,10,37,34,0,Matches
48,Maghnes Akliouche,fr FRA,"MF,FW",Monaco,fr Ligue 1,21-343,2002,7.3,14,10,5,7,2,5,15,33.3,10,8,0,8,5,19,0,0,Matches
49,Paul Akouokou,ci CIV,MF,Betis,es La Liga,26-045,1997,0.3,5,3,0,2,3,3,3,100,0,3,1,2,1,6,1,0,Matches
50,Paul Akouokou,ci CIV,MF,Lyon,fr Ligue 1,26-045,1997,3.3,14,9,2,10,2,6,7,85.7,1,5,1,4,6,20,9,0,Matches
51,Jean-Daniel Akpa-Akpro,ci CIV,MF,Monza,it Serie A,31-115,1992,3.3,9,3,6,2,1,1,4,25,3,3,2,1,6,15,5,0,Matches
52,Kevin Akpoguma,ng NGA,DF,Hoffenheim,de Bundesliga,28-290,1995,7.4,22,11,15,6,1,16,20,80,4,15,6,9,10,32,19,0,Matches
53,David Alaba,at AUT,DF,Real Madrid,es La Liga,31-224,1992,12.8,13,9,7,5,1,4,8,50,4,10,7,3,15,28,34,0,Matches
54,Luis Alberto,es ESP,MF,Lazio,it Serie A,31-128,1992,15.1,25,14,12,8,5,10,32,31.3,22,24,2,22,3,28,7,0,Matches
55,Raúl Albiol,es ESP,DF,Villarreal,es La Liga,38-152,1985,14.2,14,9,6,7,1,10,18,55.6,8,19,16,3,10,24,75,0,Matches
56,Rubén Alcaraz,es ESP,MF,Cádiz,es La Liga,32-278,1991,19.8,50,29,22,25,3,22,64,34.4,42,40,9,31,20,70,37,0,Matches
57,Omar Alderete,py PAR,DF,Getafe,es La Liga,27-039,1996,10.1,8,7,6,2,0,5,12,41.7,7,16,9,7,4,12,55,0,Matches
58,Iván Alejo,es ESP,MF,Cádiz,es La Liga,28-358,1995,15.3,31,14,19,7,5,14,50,28,36,17,0,17,3,34,16,0,Matches
59,Carles Aleñá,es ESP,MF,Getafe,es La Liga,26-029,1998,7.5,13,5,4,7,2,4,13,30.8,9,12,3,9,3,16,9,0,Matches
60,Trent Alexander-Arnold,eng ENG,DF,Liverpool,eng Premier League,25-119,1998,16.9,26,18,17,8,1,18,59,30.5,41,12,1,11,22,48,37,3,Matches
61,Mohamed Ali Cho,fr FRA,"FW,MF",Real Sociedad,es La Liga,20-015,2004,2.8,4,3,3,1,0,2,7,28.6,5,6,0,6,1,5,1,0,Matches
62,Mohamed Ali Cho,fr FRA,FW,Nice,fr Ligue 1,20-015,2004,1,1,1,0,1,0,0,1,0,1,1,0,1,1,2,2,0,Matches
63,Yanis Ali Issoufou,fr FRA,FW,Montpellier,fr Ligue 1,17-098,2006,0.1,,0,,,,,,,,,,,0,,,,Matches
64,Faride Alidou,de GER,"FW,MF",Köln,de Bundesliga,22-200,2001,4.2,6,1,3,2,1,2,8,25,6,10,1,9,3,9,4,1,Matches
65,Nabil Alioui,fr FRA,"MF,FW",Le Havre,fr Ligue 1,24-350,1999,11.2,3,2,2,1,0,2,4,50,2,6,1,5,3,6,4,0,Matches
66,Alisson,br BRA,GK,Liverpool,eng Premier League,31-124,1992,20,0,0,0,0,0,0,1,0,1,0,0,0,0,0,9,2,Matches
67,Jim Allevinah,ga GAB,"DF,MF",Clermont Foot,fr Ligue 1,28-341,1995,14,20,11,7,9,4,10,26,38.5,16,17,3,14,9,29,18,0,Matches
68,Domingos André Ribeiro Almeida,pt POR,"FW,MF",Valencia,es La Liga,23-249,2000,5.3,11,6,3,6,2,5,10,50,5,4,0,4,2,13,2,0,Matches
69,Miguel Almirón,py PAR,FW,Newcastle Utd,eng Premier League,29-358,1994,16.4,32,21,10,15,7,11,24,45.8,13,23,2,21,8,40,10,0,Matches
70,Pontus Almqvist,se SWE,FW,Lecce,it Serie A,24-208,1999,14.4,26,17,10,13,3,11,29,37.9,18,15,0,15,10,36,8,0,Matches
71,Marcos Alonso,es ESP,DF,Barcelona,es La Liga,33-037,1990,1.8,5,3,2,3,0,3,4,75,1,2,0,2,4,9,3,0,Matches
72,Adrià Altimira,es ESP,"DF,MF",Villarreal,es La Liga,22-312,2001,8.6,16,7,9,6,1,9,24,37.5,15,18,5,13,5,21,18,0,Matches
73,Sergi Altimira,es ESP,MF,Betis,es La Liga,22-162,2001,4.4,13,7,7,5,1,9,19,47.4,10,11,1,10,6,19,8,0,Matches
74,Edson Álvarez,mx MEX,MF,West Ham,eng Premier League,26-102,1997,15.9,46,25,27,16,3,19,35,54.3,16,30,11,19,19,65,58,0,Matches
75,Gastón Álvarez,uy URU,DF,Getafe,es La Liga,23-316,2000,17.4,42,23,30,10,2,21,32,65.6,11,24,8,16,27,69,54,0,Matches
76,Hugo Álvarez,es ESP,MF,Celta Vigo,es La Liga,20-216,2003,0.4,1,1,0,0,1,1,2,50,1,1,0,1,1,2,0,0,Matches
77,Julián Álvarez,ar ARG,"MF,FW",Manchester City,eng Premier League,24-003,2000,19.6,13,6,2,5,6,4,18,22.2,14,19,0,19,1,14,11,0,Matches
78,Yeray Álvarez,es ESP,DF,Athletic Club,es La Liga,29-010,1995,4.1,7,6,6,1,0,3,5,60,2,2,2,0,4,11,12,0,Matches
79,Skelly Alvero,fr FRA,MF,Lyon,fr Ligue 1,21-275,2002,4.7,8,7,5,2,1,2,9,22.2,7,5,1,4,2,10,5,0,Matches
80,Papa Amadou Diallo,sn SEN,"FW,MF",Metz,fr Ligue 1,19-223,2004,3,4,2,1,2,1,2,5,40,3,3,0,3,4,8,2,0,Matches
81,Selim Amallah,ma MAR,"MF,FW",Valencia,es La Liga,27-080,1996,5.4,14,9,6,5,3,3,8,37.5,5,11,0,11,10,24,4,0,Matches
82,Amath,sn SEN,"FW,MF",Mallorca,es La Liga,27-202,1996,4.4,9,6,7,2,0,2,10,20,8,2,0,2,3,12,6,0,Matches
83,Lorenzo Amatucci,it ITA,MF,Fiorentina,it Serie A,19-363,2004,0.2,0,0,0,0,0,0,0,,0,0,0,0,0,0,0,0,Matches
84,Zeki Amdouni,ch SUI,FW,Burnley,eng Premier League,23-061,2000,16.8,22,14,1,11,10,6,21,28.6,15,15,7,8,5,27,7,0,Matches
85,Kelvin Amian,fr FRA,DF,Nantes,fr Ligue 1,25-360,1998,1,2,2,1,1,0,1,2,50,1,0,0,0,0,2,1,0,Matches
86,Bruno Amione,ar ARG,DF,Hellas Verona,it Serie A,22-031,2002,6.4,11,3,9,2,0,4,5,80,1,4,2,2,9,20,19,2,Matches
87,Michael Amir Murillo,pa PAN,DF,Marseille,fr Ligue 1,27-357,1996,7.1,14,6,7,4,3,8,11,72.7,3,5,1,4,5,19,13,0,Matches
88,Nadiem Amiri,de GER,MF,Leverkusen,de Bundesliga,27-099,1996,1,4,2,0,3,1,0,3,0,3,0,0,0,0,4,1,0,Matches
89,Kofi Amoako,de GER,MF,Wolfsburg,de Bundesliga,18-273,2005,0,0,0,0,0,0,0,0,,0,0,0,0,0,0,0,0,Matches
90,Sofyan Amrabat,ma MAR,"MF,DF",Manchester Utd,eng Premier League,27-166,1996,6.8,21,13,12,7,2,14,22,63.6,8,12,3,9,4,25,11,1,Matches
91,Joachim Andersen,dk DEN,DF,Crystal Palace,eng Premier League,27-248,1996,22,31,19,23,7,1,17,23,73.9,6,23,15,8,22,53,111,1,Matches
92,Elliot Anderson,sct SCO,"MF,FW",Newcastle Utd,eng Premier League,21-089,2002,4.6,8,6,3,4,1,3,9,33.3,6,6,3,3,2,10,6,0,Matches
93,Felipe Anderson,br BRA,FW,Lazio,it Serie A,30-294,1993,16.6,41,24,14,16,11,20,47,42.6,27,22,0,22,20,61,15,0,Matches
94,Benjamin André,fr FRA,MF,Lille,fr Ligue 1,33-184,1990,17.3,55,29,25,26,4,24,51,47.1,27,22,4,18,19,74,39,0,Matches
95,Komnen Andrić,rs SRB,FW,Clermont Foot,fr Ligue 1,28-217,1995,1.4,2,1,0,1,1,0,1,0,1,2,0,2,0,2,1,0,Matches
96,Robert Andrich,de GER,"MF,DF",Leverkusen,de Bundesliga,29-134,1994,5.8,5,4,0,4,1,2,5,40,3,7,2,5,8,13,9,0,Matches
97,Miguel Ángel Rubio,es ESP,DF,Granada,es La Liga,25-329,1998,6.3,8,4,5,3,0,7,8,87.5,1,14,8,6,12,20,23,1,Matches
98,Fabrizio Angileri,ar ARG,"DF,MF",Getafe,es La Liga,29-325,1994,1.1,0,0,0,0,0,0,2,0,2,0,0,0,2,2,5,0,Matches
99,Jaidon Anthony,eng ENG,FW,Bournemouth,eng Premier League,24-064,1999,1.7,3,1,1,0,2,1,7,14.3,6,3,0,3,1,4,3,0,Matches
100,Waldemar Anton,de GER,DF,Stuttgart,de Bundesliga,27-198,1996,18.6,22,16,9,12,1,13,24,54.2,11,17,10,7,26,48,79,1,Matches
101,Michail Antonio,jm JAM,FW,West Ham,eng Premier League,33-312,1990,9,8,4,3,3,2,3,4,75,1,9,3,6,1,9,1,0,Matches
102,Antony,br BRA,FW,Manchester Utd,eng Premier League,23-344,2000,10.3,27,14,10,12,5,15,29,51.7,14,20,1,19,8,35,4,0,Matches
103,Christopher Antwi-Adjei,gh GHA,"FW,MF",Bochum,de Bundesliga,29-361,1994,9.8,15,8,7,5,3,7,17,41.2,10,8,2,6,1,16,8,1,Matches
104,Houssem Aouar,dz ALG,MF,Roma,it Serie A,25-218,1998,4.9,12,9,3,8,1,2,8,25,6,4,0,4,4,16,1,0,Matches
105,Stredair Appuah,fr FRA,FW,Nantes,fr Ligue 1,19-221,2004,0.3,0,0,0,0,0,0,1,0,1,0,0,0,0,0,0,0,Matches
106,Mauro Arambarri,uy URU,MF,Getafe,es La Liga,28-126,1995,3.8,6,2,3,2,1,1,6,16.7,5,1,0,1,2,8,7,0,Matches
107,Jon Aramburu,ve VEN,DF,Real Sociedad,es La Liga,21-195,2002,1.5,4,2,3,1,0,1,1,100,0,0,0,0,1,5,5,0,Matches
108,Julian Araujo,mx MEX,DF,Las Palmas,es La Liga,22-174,2001,11.1,27,15,18,5,4,17,26,65.4,9,16,10,6,8,35,39,1,Matches
109,Ronald Araújo,uy URU,DF,Barcelona,es La Liga,24-333,1999,14.4,18,15,6,11,1,6,9,66.7,3,15,7,8,8,26,39,2,Matches
110,Cameron Archer,eng ENG,"FW,MF",Sheffield Utd,eng Premier League,22-197,2001,14.9,14,9,6,5,3,6,14,42.9,8,15,3,12,1,15,8,0,Matches
111,Cameron Archer,eng ENG,MF,Aston Villa,eng Premier League,22-197,2001,0.1,0,0,0,0,0,0,0,,0,0,0,0,0,0,0,0,Matches
112,Alphonse Areola,fr FRA,GK,West Ham,eng Premier League,30-341,1993,19,0,0,0,0,0,0,2,0,2,0,0,0,0,0,8,0,Matches
113,Adu Ares,es ESP,FW,Athletic Club,es La Liga,22-114,2001,1.4,6,3,3,1,2,2,3,66.7,1,1,0,1,1,7,0,0,Matches
114,Jesús Areso,es ESP,DF,Osasuna,es La Liga,24-216,1999,15.5,23,12,12,8,3,16,18,88.9,2,19,7,12,9,32,37,0,Matches
115,Matias Arezo,uy URU,FW,Granada,es La Liga,21-074,2002,1.6,2,0,0,2,0,0,2,0,2,1,0,1,0,2,3,0,Matches
116,Yoël Armougom,fr FRA,"DF,MF",Clermont Foot,fr Ligue 1,25-243,1998,0.6,0,0,0,0,0,0,0,,0,0,0,0,0,0,1,0,Matches
117,José Arnaiz,es ESP,"FW,MF",Osasuna,es La Liga,28-294,1995,6.1,7,4,3,2,2,2,14,14.3,12,6,0,6,3,10,1,0,Matches
118,Hákon Arnar Haraldsson,is ISL,"FW,MF",Lille,fr Ligue 1,20-299,2003,4.3,3,3,1,2,0,1,10,10,9,0,0,0,1,4,3,0,Matches
119,Marko Arnautović,at AUT,FW,Inter,it Serie A,34-290,1989,4.3,4,1,2,2,0,2,3,66.7,1,4,1,3,4,8,3,0,Matches
120,Maximilian Arnold,de GER,MF,Wolfsburg,de Bundesliga,29-252,1994,12.9,23,17,7,11,5,13,23,56.5,10,9,1,8,18,41,29,0,Matches
121,Mohamed El Arouch,fr FRA,FW,Lyon,fr Ligue 1,19-303,2004,0,0,0,0,0,0,0,0,,0,0,0,0,0,0,0,0,Matches
122,Sergio Arribas,es ESP,"MF,FW",Almería,es La Liga,22-126,2001,16.5,28,14,14,13,1,10,20,50,10,11,1,10,11,39,5,1,Matches
123,Kepa Arrizabalaga,es ESP,GK,Real Madrid,es La Liga,29-123,1994,12,0,0,0,0,0,0,1,0,1,0,0,0,0,0,4,0,Matches
124,Arthur,br BRA,DF,Leverkusen,de Bundesliga,20-323,2003,0.4,2,2,1,0,1,2,2,100,0,0,0,0,0,2,1,0,Matches
125,Takuma Asano,jp JPN,"FW,MF",Bochum,de Bundesliga,29-085,1994,13.1,10,2,2,4,4,4,13,30.8,9,6,1,5,2,12,8,0,Matches
126,Marco Asensio,es ESP,"FW,MF",Paris S-G,fr Ligue 1,28-013,1996,4.9,4,3,2,2,0,1,3,33.3,2,5,0,5,0,4,2,0,Matches
127,Kristjan Asllani,al ALB,MF,Inter,it Serie A,21-331,2002,2.8,2,0,1,1,0,0,2,0,2,4,1,3,6,8,5,0,Matches
128,Joel Asoro,se SWE,FW,Metz,fr Ligue 1,24-282,1999,8,11,8,6,5,0,3,9,33.3,6,5,0,5,3,14,8,0,Matches
129,Iago Aspas,es ESP,FW,Celta Vigo,es La Liga,36-186,1987,17.5,2,1,0,2,0,0,7,0,7,10,2,8,7,9,5,0,Matches
130,Lorenz Assignon,tg TOG,DF,Rennes,fr Ligue 1,23-226,2000,11.2,24,12,12,8,4,9,24,37.5,15,9,4,5,9,33,27,1,Matches
131,Youcef Atal,dz ALG,DF,Nice,fr Ligue 1,27-262,1996,4,9,3,6,2,1,6,8,75,2,7,1,6,4,13,1,0,Matches
132,Valentin Atangana Edoa,fr FRA,MF,Reims,fr Ligue 1,18-162,2005,2.3,10,8,2,5,3,3,5,60,2,2,0,2,4,14,1,0,Matches
133,Arthur Atta,fr FRA,MF,Metz,fr Ligue 1,21-020,2003,1.4,3,2,0,1,2,1,4,25,3,2,0,2,2,5,5,0,Matches
134,Noah Atubolu,de GER,GK,Freiburg,de Bundesliga,21-254,2002,19,0,0,0,0,0,0,1,0,1,0,0,0,0,0,3,0,Matches
135,Pierre-Emerick Aubameyang,ga GAB,FW,Marseille,fr Ligue 1,34-230,1989,15.4,10,6,2,6,2,2,11,18.2,9,13,3,10,7,17,13,0,Matches
136,Tommaso Augello,it ITA,DF,Cagliari,it Serie A,29-157,1994,14.6,17,12,12,3,2,12,17,70.6,5,11,5,6,5,22,36,0,Matches
137,Yann Aurel Bisseck,de GER,DF,Inter,it Serie A,23-066,2000,4.3,5,2,2,2,1,3,5,60,2,1,1,0,0,5,9,0,Matches
138,Serge Aurier,ci CIV,"DF,MF",Nott'ham Forest,eng Premier League,31-041,1992,9.3,20,14,9,11,0,5,11,45.5,6,10,3,7,9,29,36,1,Matches
139,Ezequiel Ávila,ar ARG,"FW,MF",Osasuna,es La Liga,29-362,1994,9.6,3,2,1,1,1,3,11,27.3,8,14,0,14,4,7,8,0,Matches
140,Taiwo Awoniyi,ng NGA,FW,Nott'ham Forest,eng Premier League,26-175,1997,7.9,5,3,1,3,1,0,1,0,1,3,0,3,0,5,8,0,Matches
141,André Ayew,gh GHA,"MF,FW",Le Havre,fr Ligue 1,34-048,1989,0.6,0,0,0,0,0,0,1,0,1,0,0,0,0,0,0,0,Matches
142,Jordan Ayew,gh GHA,"FW,MF",Crystal Palace,eng Premier League,32-145,1991,18.2,43,24,16,17,10,11,26,42.3,15,28,2,26,13,56,9,0,Matches
143,Neil El Aynaoui,fr FRA,MF,Lens,fr Ligue 1,22-216,2001,8.1,14,7,5,7,2,7,19,36.8,12,12,3,9,11,25,10,0,Matches
144,Sardar Azmoun,ir IRN,"FW,MF",Roma,it Serie A,29-033,1995,2.7,6,4,2,3,1,3,7,42.9,4,0,0,0,2,8,3,1,Matches
145,César Azpilicueta,es ESP,DF,Atlético Madrid,es La Liga,34-159,1989,10.6,20,12,11,8,1,10,16,62.5,6,19,4,15,12,32,32,0,Matches
146,Paulo Azzi,br BRA,"DF,MF",Cagliari,it Serie A,29-203,1994,8.1,18,11,9,6,3,8,16,50,8,9,1,8,14,32,20,0,Matches
147,Oussama El Azzouzi,ma MAR,MF,Bologna,it Serie A,22-250,2001,2.2,5,3,1,3,1,3,6,50,3,3,2,1,4,9,6,0,Matches
148,Abdellah Baallal,ma MAR,MF,Clermont Foot,fr Ligue 1,19-088,2004,0,0,0,0,0,0,0,0,,0,1,0,1,0,0,0,0,Matches
149,Iddrisu Baba,gh GHA,MF,Almería,es La Liga,28-012,1996,10.8,31,18,16,15,0,10,25,40,15,10,2,8,11,42,14,1,Matches
150,Srđan Babić,rs SRB,DF,Almería,es La Liga,27-287,1996,1,2,2,0,2,0,1,1,100,0,1,1,0,0,2,2,0,Matches
151,Shavy Babicka,ga GAB,FW,Toulouse,fr Ligue 1,23-247,2000,0.7,1,1,1,0,0,0,0,,0,0,0,0,0,1,0,0,Matches
152,Aliou Badara Baldé,sn SEN,FW,Nice,fr Ligue 1,21-053,2002,0.5,1,1,0,1,0,0,0,,0,1,1,0,1,2,0,0,Matches
153,Loïc Bade,fr FRA,DF,Sevilla,es La Liga,23-298,2000,12.1,26,17,22,4,0,12,21,57.1,9,16,10,6,18,44,59,0,Matches
154,Milan Badelj,hr CRO,MF,Genoa,it Serie A,34-343,1989,15.5,28,15,11,17,0,15,36,41.7,21,23,5,18,31,59,26,0,Matches
155,Matthias Bader,de GER,"DF,MF",Darmstadt 98,de Bundesliga,26-231,1997,12.3,27,15,15,6,6,15,32,46.9,17,11,2,9,17,44,14,0,Matches
156,Benoît Badiashile,fr FRA,DF,Chelsea,eng Premier League,22-314,2001,6.1,13,10,8,5,0,6,10,60,4,9,4,5,5,18,31,1,Matches
157,Alex Baena,es ESP,"MF,FW",Villarreal,es La Liga,22-198,2001,15.6,15,10,5,4,6,7,20,35,13,11,1,10,6,21,6,1,Matches
158,Jaime Báez,uy URU,"FW,MF",Frosinone,it Serie A,28-284,1995,5.5,4,1,0,2,2,0,7,0,7,5,0,5,4,8,1,0,Matches
159,Leon Bailey,jm JAM,"MF,FW",Aston Villa,eng Premier League,26-178,1997,10.6,3,2,1,0,2,1,6,16.7,5,7,0,7,5,8,3,0,Matches
160,Eric Bailly,ci CIV,DF,Villarreal,es La Liga,29-297,1994,3.8,1,1,1,0,0,0,0,,0,2,2,0,8,9,13,1,Matches
161,Nedim Bajrami,al ALB,"MF,FW",Sassuolo,it Serie A,24-340,1999,7.7,6,2,2,3,1,1,4,25,3,2,1,1,4,10,5,0,Matches
162,Tiemoué Bakayoko,fr FRA,MF,Lorient,fr Ligue 1,29-170,1994,5.4,12,9,5,6,1,1,4,25,3,5,3,2,8,20,2,0,Matches
163,Mitchel Bakker,nl NED,DF,Atalanta,it Serie A,23-228,2000,2.5,5,2,5,0,0,1,8,12.5,7,4,0,4,1,6,4,0,Matches
164,Ridle Baku,de GER,"DF,MF",Wolfsburg,de Bundesliga,25-301,1998,10.5,14,7,9,2,3,9,17,52.9,8,14,0,14,11,25,30,1,Matches
165,Dilane Bakwa,fr FRA,"FW,MF",Strasbourg,fr Ligue 1,21-161,2002,13.1,25,19,9,12,4,8,29,27.6,21,10,0,10,15,40,7,0,Matches
166,Tommaso Baldanzi,it ITA,"MF,FW",Empoli,it Serie A,20-317,2003,8.3,4,2,1,1,2,3,10,30,7,7,0,7,2,6,0,0,Matches
167,Alejandro Balde,es ESP,DF,Barcelona,es La Liga,20-108,2003,15.3,20,11,11,6,3,7,11,63.6,4,14,1,13,5,25,21,1,Matches
168,George Baldock,gr GRE,DF,Sheffield Utd,eng Premier League,30-331,1993,9.3,17,9,9,7,1,6,14,42.9,8,12,8,4,9,26,27,0,Matches
169,Carlos Baleba,cm CMR,MF,Brighton,eng Premier League,20-031,2004,6.5,23,11,11,10,2,11,23,47.8,12,14,4,10,10,33,15,1,Matches
170,Carlos Baleba,cm CMR,MF,Lille,fr Ligue 1,20-031,2004,0.7,6,2,1,4,1,3,4,75,1,0,0,0,2,8,0,0,Matches
171,Leonardo Balerdi,ar ARG,DF,Marseille,fr Ligue 1,25-008,1999,12.4,37,21,27,9,1,26,32,81.3,6,20,8,12,26,63,54,0,Matches
172,Iván Balliu,al ALB,DF,Rayo Vallecano,es La Liga,32-033,1992,18.1,23,16,11,12,0,12,19,63.2,7,17,6,11,20,43,46,1,Matches
173,Fodé Ballo-Touré,sn SEN,DF,Fulham,eng Premier League,27-031,1997,0.6,2,1,1,1,0,1,1,100,0,1,0,1,3,5,2,0,Matches
174,Folarin Balogun,us USA,FW,Monaco,fr Ligue 1,22-215,2001,10.5,7,1,1,5,1,3,10,30,7,4,0,4,2,9,2,0,Matches
175,Jonathan Bamba,ci CIV,"MF,FW",Celta Vigo,es La Liga,27-314,1996,15.6,11,7,4,5,2,1,11,9.1,10,15,0,15,11,22,9,0,Matches
176,Muhamad Bamba,ci CIV,MF,Lorient,fr Ligue 1,22-055,2001,0.2,,0,,,,,,,,,,,0,,,,Matches
177,Samuel Bamba,de GER,FW,Dortmund,de Bundesliga,19-355,2004,0.5,1,1,1,0,0,1,2,50,1,0,0,0,0,1,1,0,Matches
178,Lameck Banda,zm ZAM,FW,Lecce,it Serie A,23-005,2001,11.9,21,17,9,9,3,5,19,26.3,14,18,0,18,3,24,5,0,Matches
179,Daniel Bandeira,pt POR,MF,Hellas Verona,it Serie A,23-298,2000,0.1,0,0,0,0,0,0,0,,0,0,0,0,0,0,1,0,Matches
180,Mamady Bangré,bf BFA,"FW,MF",Toulouse,fr Ligue 1,22-233,2001,1.1,4,2,2,2,0,3,4,75,1,0,0,0,4,8,3,0,Matches
181,Mattia Bani,it ITA,DF,Genoa,it Serie A,30-055,1993,15.7,12,4,10,2,0,4,11,36.4,7,33,20,13,10,22,72,1,Matches
182,Léo Baptistão,br BRA,FW,Almería,es La Liga,31-161,1992,12,14,8,6,4,4,5,16,31.3,11,6,1,5,6,20,14,0,Matches
183,Shandon Baptiste,gd GRN,MF,Brentford,eng Premier League,25-301,1998,2.3,4,4,2,2,0,1,5,20,4,5,1,4,3,7,6,0,Matches
184,Antonín Barák,cz CZE,MF,Fiorentina,it Serie A,29-062,1994,2.6,2,1,1,0,1,1,3,33.3,2,4,0,4,0,2,2,0,Matches
185,Francisco Barbosa,es ESP,GK,Betis,es La Liga,24-272,1999,2.5,0,0,0,0,0,0,0,,0,0,0,0,0,0,2,0,Matches
186,Bradley Barcola,fr FRA,FW,Lyon,fr Ligue 1,21-154,2002,3,5,2,0,2,3,1,7,14.3,6,4,0,4,2,7,0,0,Matches
187,Bradley Barcola,fr FRA,"FW,MF",Paris S-G,fr Ligue 1,21-154,2002,8.7,23,11,10,8,5,5,14,35.7,9,20,2,18,6,29,8,1,Matches
188,Melvin Bard,fr FRA,DF,Nice,fr Ligue 1,23-089,2000,17.7,38,21,10,21,7,17,31,54.8,14,27,6,21,29,67,29,0,Matches
189,Nicolò Barella,it ITA,MF,Inter,it Serie A,26-361,1997,17.1,26,15,10,11,5,12,40,30,28,13,0,13,4,30,7,0,Matches
190,Kike Barja,es ESP,"FW,MF",Osasuna,es La Liga,26-308,1997,2.9,5,2,2,2,1,3,6,50,3,1,1,0,1,6,2,0,Matches
191,Ross Barkley,eng ENG,MF,Luton Town,eng Premier League,30-060,1993,13.8,25,10,7,13,5,5,25,20,20,12,6,6,13,38,25,1,Matches
192,Aymen Barkok,ma MAR,"MF,FW",Mainz 05,de Bundesliga,25-258,1998,3.6,9,5,2,6,1,3,6,50,3,7,0,7,2,11,1,0,Matches
193,Harvey Barnes,eng ENG,FW,Newcastle Utd,eng Premier League,26-056,1997,2.1,1,0,0,1,0,0,1,0,1,0,0,0,1,2,0,0,Matches
194,Leandro Barreiro Martins,lu LUX,MF,Mainz 05,de Bundesliga,24-031,2000,15,32,21,8,18,6,12,26,46.2,14,26,10,16,25,57,25,0,Matches
195,Enzo Barrenechea,ar ARG,MF,Frosinone,it Serie A,22-257,2001,19,44,28,18,20,6,19,48,39.6,29,27,6,21,22,66,39,2,Matches
196,Ander Barrenetxea,es ESP,"FW,MF",Real Sociedad,es La Liga,22-038,2001,9.9,15,7,3,9,3,5,19,26.3,14,7,0,7,5,20,3,0,Matches
197,Pablo Barrios,es ESP,MF,Atlético Madrid,es La Liga,20-233,2003,9,21,12,9,11,1,9,19,47.4,10,12,1,11,14,35,12,1,Matches
198,Davide Bartesaghi,it ITA,"DF,MF",Milan,it Serie A,18-036,2005,0.8,1,0,0,1,0,1,3,33.3,2,1,1,0,0,1,4,0,Matches
199,Marc Bartra,es ESP,DF,Betis,es La Liga,33-019,1991,2.5,4,3,3,1,0,4,5,80,1,3,1,2,3,7,10,0,Matches
200,Federico Baschirotto,it ITA,DF,Lecce,it Serie A,27-136,1996,21.6,13,7,10,3,0,4,8,50,4,28,19,9,18,31,88,0,Matches
201,Steven Baseya,fr FRA,DF,Strasbourg,fr Ligue 1,19-020,2005,0.1,2,1,1,1,0,1,1,100,0,0,0,0,0,2,1,0,Matches
202,Chris Basham,eng ENG,"DF,MF",Sheffield Utd,eng Premier League,35-198,1988,3.6,7,2,4,3,0,2,9,22.2,7,9,4,5,5,12,17,0,Matches
203,Toma Bašić,hr CRO,MF,Salernitana,it Serie A,27-070,1996,1.4,4,4,1,2,1,1,2,50,1,3,0,3,2,6,3,0,Matches
204,Calvin Bassey,ng NGA,DF,Fulham,eng Premier League,24-034,1999,12.4,22,12,13,8,1,6,10,60,4,17,8,9,21,43,35,3,Matches
205,Alessandro Bastoni,it ITA,DF,Inter,it Serie A,24-296,1999,14.4,27,22,20,4,3,13,21,61.9,8,11,6,5,16,43,30,0,Matches
206,Simone Bastoni,it ITA,"DF,MF",Empoli,it Serie A,27-090,1996,3.9,14,8,9,4,1,8,13,61.5,5,6,0,6,8,22,16,0,Matches
207,Augusto Batalla,ar ARG,GK,Granada,es La Liga,27-279,1996,4,0,0,0,0,0,0,0,,0,0,0,0,0,0,0,1,Matches
208,Daniel Batz,de GER,GK,Mainz 05,de Bundesliga,33-022,1991,4,0,0,0,0,0,0,0,,0,0,0,0,0,0,3,0,Matches
209,Maximilian Bauer,de GER,DF,Augsburg,de Bundesliga,23-359,2000,5.5,9,5,5,4,0,3,9,33.3,6,8,7,1,8,17,24,1,Matches
210,Elias Baum,de GER,"MF,DF",Eint Frankfurt,de Bundesliga,18-100,2005,0.2,1,0,0,0,1,0,0,,0,1,1,0,0,1,0,0,Matches
211,Oliver Baumann,de GER,GK,Hoffenheim,de Bundesliga,33-246,1990,19,1,1,1,0,0,1,1,100,0,0,0,0,0,1,9,1,Matches
212,Christoph Baumgartner,at AUT,MF,RB Leipzig,de Bundesliga,24-186,1999,8.6,19,11,6,9,4,12,28,42.9,16,15,1,14,4,23,7,0,Matches
213,Bebé,cv CPV,"MF,FW",Rayo Vallecano,es La Liga,33-206,1990,1.6,2,2,1,1,0,1,4,25,3,1,0,1,0,2,0,0,Matches
214,Ihlas Bebou,tg TOG,"FW,DF",Hoffenheim,de Bundesliga,29-286,1994,8.7,14,8,6,6,2,6,12,50,6,7,0,7,7,21,8,0,Matches
215,Mohamed Bechikh,fr FRA,MF,Strasbourg,fr Ligue 1,18-205,2005,0,0,0,0,0,0,0,0,,0,0,0,0,0,0,0,0,Matches
216,Adrian Beck,de GER,MF,Heidenheim,de Bundesliga,26-239,1997,8.6,20,11,6,12,2,8,19,42.1,11,10,0,10,3,23,10,0,Matches
217,Owen Beck,wls WAL,DF,Liverpool,eng Premier League,21-178,2002,0.1,2,1,1,1,0,0,0,,0,0,0,0,0,2,1,0,Matches
218,Sheraldo Becker,sr SUR,FW,Real Sociedad,es La Liga,28-359,1995,0.3,0,0,0,0,0,0,0,,0,0,0,0,0,0,0,0,Matches
219,Sheraldo Becker,sr SUR,"FW,MF",Union Berlin,de Bundesliga,28-359,1995,7.2,3,3,0,2,1,0,2,0,2,2,0,2,0,3,2,0,Matches
220,Chris Bedia,ci CIV,FW,Union Berlin,de Bundesliga,27-335,1996,0.1,0,0,0,0,0,0,0,,0,1,0,1,0,0,0,0,Matches
221,Donny van de Beek,nl NED,DF,Manchester Utd,eng Premier League,26-291,1997,0,0,0,0,0,0,0,0,,0,1,0,1,0,0,0,0,Matches
222,Donny van de Beek,nl NED,"MF,FW",Eint Frankfurt,de Bundesliga,26-291,1997,1.9,3,1,0,1,2,1,3,33.3,2,1,1,0,0,3,0,0,Matches
223,Yanis Begraoui,ma MAR,"FW,MF",Toulouse,fr Ligue 1,22-214,2001,3.3,5,3,1,3,1,3,9,33.3,6,4,0,4,5,10,5,0,Matches
224,Kevin Behrens,de GER,FW,Union Berlin,de Bundesliga,33-000,1991,14,13,10,3,7,3,1,4,25,3,7,2,5,6,19,19,0,Matches
225,Maximilian Beier,de GER,FW,Hoffenheim,de Bundesliga,21-109,2002,13.2,8,4,2,4,2,2,6,33.3,4,9,0,9,0,8,6,0,Matches
226,Jérémie Bela,ao ANG,MF,Clermont Foot,fr Ligue 1,30-301,1993,0.5,0,0,0,0,0,0,0,,0,0,0,0,0,0,0,0,Matches
227,Reda Belahyane,fr FRA,MF,Nice,fr Ligue 1,19-247,2004,0.3,1,0,0,1,0,1,1,100,0,0,0,0,0,1,0,0,Matches
228,Amari'i Bell,jm JAM,DF,Luton Town,eng Premier League,29-274,1994,15.1,36,23,23,13,0,18,27,66.7,9,24,10,14,19,55,49,0,Matches
229,Stefan Bell,de GER,DF,Mainz 05,de Bundesliga,32-163,1991,7.4,8,8,7,1,0,4,8,50,4,7,5,2,6,14,30,0,Matches
230,Alaa Bellaarouch,ma MAR,GK,Strasbourg,fr Ligue 1,22-033,2002,1,0,0,0,0,0,0,0,,0,0,0,0,0,0,1,1,Matches
231,Raoul Bellanova,it ITA,DF,Torino,it Serie A,23-262,2000,17.8,17,12,6,9,2,7,14,50,7,12,2,10,10,27,18,0,Matches
232,Jean-Ricner Bellegarde,fr FRA,"MF,FW",Wolves,eng Premier League,25-221,1998,6.7,13,7,7,5,1,5,11,45.5,6,12,2,10,5,18,8,0,Matches
233,Jean-Ricner Bellegarde,fr FRA,"MF,FW",Strasbourg,fr Ligue 1,25-221,1998,3,5,3,3,2,0,3,6,50,3,4,0,4,4,9,0,0,Matches
234,Héctor Bellerín,es ESP,DF,Betis,es La Liga,28-321,1995,12.4,15,10,7,5,3,11,30,36.7,19,9,4,5,14,29,24,0,Matches
235,Jude Bellingham,eng ENG,"MF,FW",Real Madrid,es La Liga,20-219,2003,18.2,27,22,7,14,6,10,24,41.7,14,40,5,35,17,44,12,0,Matches
236,Jeanöel Belocian,fr FRA,DF,Rennes,fr Ligue 1,18-351,2005,10.8,22,15,15,7,0,14,18,77.8,4,10,6,4,11,33,31,0,Matches
237,Andrea Belotti,it ITA,FW,Fiorentina,it Serie A,30-045,1993,0.5,0,0,0,0,0,0,1,0,1,0,0,0,0,0,0,0,Matches
238,Andrea Belotti,it ITA,FW,Roma,it Serie A,30-045,1993,7.5,8,4,2,3,3,3,6,50,3,7,0,7,2,10,3,0,Matches
239,Fran Beltrán,es ESP,MF,Celta Vigo,es La Liga,25-000,1999,12.1,22,14,8,10,4,10,30,33.3,20,10,0,10,10,32,12,0,Matches
240,Lucas Beltrán,ar ARG,"FW,MF",Fiorentina,it Serie A,22-311,2001,11,16,10,4,9,3,5,8,62.5,3,18,3,15,0,16,8,0,Matches
241,Eliesse Ben Seghir,fr FRA,"MF,DF",Monaco,fr Ligue 1,18-352,2005,0.4,1,1,0,1,0,0,0,,0,1,0,1,0,1,0,0,Matches
242,Anis Ben Slimane,tn TUN,MF,Sheffield Utd,eng Premier League,22-324,2001,4.1,8,5,3,1,4,3,8,37.5,5,5,1,4,4,12,6,0,Matches
243,Wissam Ben Yedder,fr FRA,"FW,MF",Monaco,fr Ligue 1,33-175,1990,13.3,3,3,0,2,1,0,6,0,6,8,0,8,5,8,1,0,Matches
244,Carlos Benavídez,uy URU,MF,Alavés,es La Liga,25-310,1998,5.8,30,18,10,14,6,10,17,58.8,7,6,4,2,12,42,16,0,Matches
245,Ismaël Bennacer,dz ALG,MF,Milan,it Serie A,26-064,1997,2.2,4,3,1,3,0,0,2,0,2,3,0,3,1,5,2,0,Matches
246,Saïd Benrahma,dz ALG,"FW,MF",West Ham,eng Premier League,28-177,1995,6.9,8,4,5,3,0,4,15,26.7,11,8,0,8,5,13,7,0,Matches
247,Ramy Bensebaini,dz ALG,DF,Dortmund,de Bundesliga,28-293,1995,11.3,33,20,20,11,2,23,33,69.7,10,22,7,15,16,49,37,0,Matches
248,Nabil Bentaleb,dz ALG,MF,Lille,fr Ligue 1,29-071,1994,8.5,28,20,15,11,2,10,20,50,10,12,3,9,15,43,12,0,Matches
249,Rodrigo Bentancur,uy URU,MF,Tottenham,eng Premier League,26-223,1997,3.1,7,4,5,1,1,4,8,50,4,4,1,3,3,10,8,0,Matches
250,Daniel Bentley,eng ENG,GK,Wolves,eng Premier League,30-205,1993,2.8,0,0,0,0,0,0,0,,0,0,0,0,0,0,1,0,Matches
251,Lucas Beraldo,br BRA,DF,Paris S-G,fr Ligue 1,20-071,2003,2,5,2,3,2,0,2,8,25,6,4,1,3,3,8,4,0,Matches
252,Domenico Berardi,it ITA,FW,Sassuolo,it Serie A,29-186,1994,15.2,16,8,6,9,1,2,20,10,18,17,0,17,13,29,9,0,Matches
253,Yuri Berchiche,es ESP,DF,Athletic Club,es La Liga,33-358,1990,13.4,21,16,8,10,3,13,20,65,7,13,5,8,15,36,42,0,Matches
254,Álex Berenguer,es ESP,FW,Athletic Club,es La Liga,28-214,1995,8.3,9,6,4,4,1,1,8,12.5,7,11,0,11,1,10,9,0,Matches
255,Bartosz Bereszyński,pl POL,DF,Empoli,it Serie A,31-206,1992,8,20,10,12,6,2,11,17,64.7,6,7,3,4,7,27,23,0,Matches
256,Jóhann Berg Guðmundsson,is ISL,MF,Burnley,eng Premier League,33-099,1990,9.8,12,4,5,5,2,7,15,46.7,8,10,0,10,13,25,12,0,Matches
257,Sander Berge,no NOR,MF,Burnley,eng Premier League,25-354,1998,17.4,37,21,20,15,2,21,39,53.8,18,26,11,15,13,50,27,1,Matches
258,Etrit Berisha,al ALB,GK,Empoli,it Serie A,34-330,1989,14,0,0,0,0,0,0,1,0,1,0,0,0,0,0,7,1,Matches
259,Mergim Berisha,de GER,FW,Hoffenheim,de Bundesliga,25-268,1998,1.6,0,0,0,0,0,0,0,,0,2,1,1,0,0,0,0,Matches
260,Mergim Berisha,de GER,FW,Augsburg,de Bundesliga,25-268,1998,1.4,0,0,0,0,0,0,0,,0,1,0,1,0,0,3,0,Matches
261,Isaac Bernal,es ESP,FW,Sevilla,es La Liga,23-261,2000,2.3,,0,,,,,,,,,,,0,,,,Matches
262,Bernardo,br BRA,DF,Bochum,de Bundesliga,28-265,1995,18,53,33,34,16,3,21,36,58.3,15,38,14,24,33,86,65,1,Matches
263,Victor Bernth Kristiansen,dk DEN,DF,Bologna,it Serie A,21-049,2002,11.9,22,16,11,9,2,7,15,46.7,8,15,2,13,5,27,22,0,Matches
264,Matúš Bero,sk SVK,"MF,FW",Bochum,de Bundesliga,28-150,1995,9.4,16,11,9,4,3,9,22,40.9,13,14,0,14,3,19,8,0,Matches
265,Luke Berry,eng ENG,MF,Luton Town,eng Premier League,31-206,1992,0.5,0,0,0,0,0,0,0,,0,1,0,1,0,0,0,0,Matches
266,Jan-Niklas Beste,de GER,"FW,MF",Heidenheim,de Bundesliga,25-030,1999,16.7,34,19,12,11,11,12,28,42.9,16,30,1,29,13,47,18,0,Matches
267,Beto,gw GNB,FW,Everton,eng Premier League,26-003,1998,6.1,11,5,1,6,4,3,9,33.3,6,7,0,7,0,11,9,0,Matches
268,Beto,gw GNB,FW,Udinese,it Serie A,26-003,1998,0.8,1,0,0,0,1,0,0,,0,0,0,0,0,1,0,0,Matches
269,Davide Bettella,it ITA,MF,Monza,it Serie A,23-302,2000,0,0,0,0,0,0,0,0,,0,0,0,0,0,0,0,0,Matches
270,Sam Beukema,nl NED,DF,Bologna,it Serie A,25-078,1998,16.6,23,10,13,9,1,15,21,71.4,6,18,10,8,11,34,57,0,Matches
271,Jordan Beyer,de GER,DF,Burnley,eng Premier League,23-260,2000,13.7,35,20,22,12,1,14,24,58.3,10,22,15,7,16,51,68,1,Matches
272,Jaka Bijol,si SVN,DF,Udinese,it Serie A,24-363,1999,13,26,16,22,4,0,13,23,56.5,10,17,11,6,14,40,68,1,Matches
273,Philip Billing,dk DEN,MF,Bournemouth,eng Premier League,27-237,1996,13.1,27,13,4,19,4,8,23,34.8,15,27,5,22,16,43,25,1,Matches
274,Cristiano Biraghi,it ITA,DF,Fiorentina,it Serie A,31-155,1992,15.4,32,21,12,17,3,22,41,53.7,19,21,4,17,11,43,23,0,Matches
275,Davide Biraschi,it ITA,DF,Genoa,it Serie A,29-216,1994,1,3,3,1,2,0,1,3,33.3,2,0,0,0,2,5,5,0,Matches
276,Samuele Birindelli,it ITA,DF,Monza,it Serie A,24-199,1999,8.4,15,9,8,5,2,7,11,63.6,4,16,6,10,9,24,19,0,Matches
277,Tom Bischof,de GER,"MF,FW",Hoffenheim,de Bundesliga,18-220,2005,1.7,7,4,5,1,1,1,8,12.5,7,1,0,1,1,8,2,0,Matches
278,Yves Bissouma,ml MLI,MF,Tottenham,eng Premier League,27-157,1996,13.4,50,31,21,21,8,27,38,71.1,11,17,4,13,20,70,26,2,Matches
279,Leonardo Bittencourt,de GER,MF,Werder Bremen,de Bundesliga,30-046,1993,9.5,23,12,13,8,2,7,22,31.8,15,12,0,12,8,31,4,0,Matches
280,Marco Bizot,nl NED,GK,Brest,fr Ligue 1,32-330,1991,19,0,0,0,0,0,0,0,,0,0,0,0,0,0,12,1,Matches
281,Antonio Blanco,es ESP,MF,Alavés,es La Liga,23-195,2000,14.8,37,23,20,15,2,18,43,41.9,25,13,0,13,19,56,17,0,Matches
282,Rubén Blanco,es ESP,GK,Marseille,fr Ligue 1,28-193,1995,0.3,0,0,0,0,0,0,0,,0,0,0,0,0,0,0,0,Matches
283,Hendry Blank,de GER,DF,Dortmund,de Bundesliga,19-166,2004,0.5,1,0,1,0,0,1,1,100,0,1,0,1,0,1,4,0,Matches
284,Ludovic Blas,fr FRA,"FW,MF",Rennes,fr Ligue 1,26-034,1997,10.9,15,8,6,9,0,7,17,41.2,10,13,1,12,5,20,4,0,Matches
285,Janis Blaswich,de GER,GK,RB Leipzig,de Bundesliga,32-277,1991,19,1,1,1,0,0,0,0,,0,0,0,0,0,1,6,3,Matches
286,Alexis Blin,fr FRA,"MF,DF",Lecce,it Serie A,27-140,1996,7.1,16,9,6,10,0,9,20,45,11,8,1,7,10,26,15,0,Matches
287,Daley Blind,nl NED,DF,Girona,es La Liga,33-331,1990,21,32,13,20,11,1,19,30,63.3,11,29,13,16,15,47,80,0,Matches
288,Myron Boadu,nl NED,FW,Monaco,fr Ligue 1,23-020,2001,0.9,2,2,0,1,1,1,2,50,1,2,0,2,0,2,0,0,Matches
289,Benicio Boaitey,eng ENG,"DF,FW",Brighton,eng Premier League,20-025,2004,0.2,0,0,0,0,0,0,0,,0,0,0,0,0,0,2,0,Matches
290,Oscar Bobb,no NOR,"FW,MF",Manchester City,eng Premier League,20-206,2003,1.3,3,0,1,0,2,1,1,100,0,2,0,2,1,4,1,0,Matches
291,Jeremie Boga,ci CIV,FW,Nice,fr Ligue 1,27-031,1997,11.3,7,4,1,6,0,4,11,36.4,7,14,1,13,2,9,2,0,Matches
292,Jayden Bogle,eng ENG,DF,Sheffield Utd,eng Premier League,23-191,2000,15.5,37,19,24,11,2,20,43,46.5,23,22,5,17,21,58,49,0,Matches
293,Emil Bohinen,no NOR,FW,Genoa,it Serie A,24-328,1999,0,0,0,0,0,0,0,0,,0,0,0,0,0,0,1,0,Matches
294,Emil Bohinen,no NOR,MF,Salernitana,it Serie A,24-328,1999,5.9,8,6,5,3,0,2,10,20,8,8,2,6,14,22,6,1,Matches
295,Adama Bojang,gm GAM,FW,Reims,fr Ligue 1,19-251,2004,0.2,1,0,0,0,1,0,0,,0,1,0,1,0,1,0,0,Matches
296,Daniel Boloca,ro ROU,MF,Sassuolo,it Serie A,25-043,1998,16.5,39,27,12,23,4,21,31,67.7,10,17,8,9,11,50,22,2,Matches
297,Willy Boly,ci CIV,DF,Nott'ham Forest,eng Premier League,33-000,1991,11.1,30,18,26,4,0,13,23,56.5,10,19,14,5,20,50,68,0,Matches
298,Giacomo Bonaventura,it ITA,MF,Fiorentina,it Serie A,34-165,1989,17.1,15,7,2,5,8,3,11,27.3,8,14,0,14,8,23,4,0,Matches
299,Federico Bonazzoli,it ITA,"FW,MF",Hellas Verona,it Serie A,26-258,1997,6.8,1,0,0,1,0,0,4,0,4,5,0,5,2,3,1,0,Matches
300,Warren Bondo,fr FRA,MF,Monza,it Serie A,20-141,2003,4.6,10,6,4,5,1,5,6,83.3,1,5,1,4,3,13,3,0,Matches
301,Giovanni Bonfanti,it ITA,DF,Atalanta,it Serie A,21-017,2003,0.2,0,0,0,0,0,0,0,,0,0,0,0,0,0,1,0,Matches
302,Victor Boniface,ng NGA,FW,Leverkusen,de Bundesliga,23-042,2000,14.2,6,4,0,1,5,1,4,25,3,5,0,5,0,6,10,0,Matches
303,Kevin Bonifazi,it ITA,DF,Bologna,it Serie A,27-260,1996,1,4,0,0,4,0,1,2,50,1,0,0,0,0,4,7,1,Matches
304,Kevin Bonifazi,it ITA,DF,Frosinone,it Serie A,27-260,1996,1,3,2,0,3,0,0,1,0,1,1,0,1,1,4,6,0,Matches
305,Leonardo Bonucci,it ITA,DF,Union Berlin,de Bundesliga,36-278,1987,5.1,6,5,2,4,0,4,4,100,0,5,3,2,7,13,16,0,Matches
306,Ângelo Borges,br BRA,"FW,MF",Strasbourg,fr Ligue 1,19-044,2004,10.8,23,11,9,7,7,11,30,36.7,19,17,0,17,8,31,1,0,Matches
307,Neto Borges,br BRA,DF,Clermont Foot,fr Ligue 1,27-143,1996,15,26,14,11,12,3,15,34,44.1,19,14,3,11,29,55,32,0,Matches
308,Yvandro Borges Sanches,lu LUX,"MF,FW",M'Gladbach,de Bundesliga,19-255,2004,0.2,0,0,0,0,0,0,0,,0,0,0,0,0,0,0,0,Matches
309,Sebastiaan Bornauw,be BEL,DF,Wolfsburg,de Bundesliga,24-318,1999,7.2,11,4,9,2,0,8,11,72.7,3,14,8,6,11,22,37,0,Matches
310,Rafael Borré,co COL,FW,Werder Bremen,de Bundesliga,28-141,1995,10.4,10,7,2,4,4,5,16,31.3,11,6,0,6,2,12,10,0,Matches
311,Gennaro Borrelli,it ITA,FW,Frosinone,it Serie A,23-330,2000,0.3,0,0,0,0,0,0,0,,0,0,0,0,0,0,0,0,Matches
312,Adri Bosch,es ESP,DF,Granada,es La Liga,22-239,2001,0.3,1,1,1,0,0,0,0,,0,0,0,0,0,1,1,0,Matches
313,Erik Botheim,no NOR,"FW,MF",Salernitana,it Serie A,24-024,2000,3.5,2,0,2,0,0,0,1,0,1,3,0,3,0,2,2,0,Matches
314,Sven Botman,nl NED,DF,Newcastle Utd,eng Premier League,24-022,2000,9.5,11,9,8,3,0,5,8,62.5,3,11,10,1,6,17,34,2,Matches
315,Ayyoub Bouaddi,fr FRA,MF,Lille,fr Ligue 1,16-124,2007,0.9,5,2,5,0,0,1,4,25,3,2,0,2,1,6,2,0,Matches
316,Badredine Bouanani,dz ALG,FW,Nice,fr Ligue 1,19-057,2004,1.8,3,2,1,1,1,3,4,75,1,5,0,5,3,6,0,0,Matches
317,Hicham Boudaoui,dz ALG,MF,Nice,fr Ligue 1,24-133,1999,8.9,21,9,6,12,3,11,15,73.3,4,7,0,7,5,26,3,0,Matches
318,Yassine Bounou,ma MAR,GK,Sevilla,es La Liga,32-304,1991,1,0,0,0,0,0,0,0,,0,0,0,0,0,0,0,0,Matches
319,Mehdi Bourabia,ma MAR,MF,Frosinone,it Serie A,32-180,1991,2.2,5,4,1,4,0,2,4,50,2,3,0,3,0,5,4,0,Matches
320,Benjamin Bourigeaud,fr FRA,"MF,DF",Rennes,fr Ligue 1,30-020,1994,15.3,21,12,11,6,4,10,26,38.5,16,17,2,15,16,37,24,0,Matches
321,Bilal Boutobba,fr FRA,"MF,FW",Clermont Foot,fr Ligue 1,25-158,1998,5,9,5,3,3,3,3,8,37.5,5,3,0,3,5,14,0,0,Matches
322,Hugo Boutsingkham,fr FRA,FW,Nantes,fr Ligue 1,21-014,2003,0,0,0,0,0,0,0,0,,0,0,0,0,0,0,0,0,Matches
323,Edoardo Bove,it ITA,MF,Roma,it Serie A,21-263,2002,14.2,47,26,11,26,10,24,39,61.5,15,21,1,20,6,53,7,1,Matches
324,Jarrod Bowen,eng ENG,FW,West Ham,eng Premier League,27-045,1996,21,26,16,11,7,8,9,19,47.4,10,29,5,24,15,41,11,0,Matches
325,Lucas Boyé,ar ARG,FW,Granada,es La Liga,27-340,1996,15.5,31,19,8,17,6,9,20,45,11,23,3,20,4,35,29,0,Matches
326,Domagoj Bradarić,hr CRO,DF,Salernitana,it Serie A,24-055,1999,18.7,25,16,9,10,6,12,18,66.7,6,12,4,8,23,48,38,1,Matches
327,Conor Bradley,nir NIR,DF,Liverpool,eng Premier League,20-209,2003,1.7,6,4,1,4,1,4,6,66.7,2,5,0,5,1,7,5,0,Matches
328,Bilal Brahimi,dz ALG,FW,Nice,fr Ligue 1,23-326,2000,0.1,0,0,0,0,0,0,1,0,1,0,0,0,0,0,0,0,Matches
329,Bilal Brahimi,dz ALG,"FW,MF",Brest,fr Ligue 1,23-326,2000,2,0,0,0,0,0,0,3,0,3,2,0,2,0,0,0,0,Matches
330,Juan Brandáriz,es ESP,DF,Almería,es La Liga,24-338,1999,17.4,27,17,18,9,0,14,19,73.7,5,26,18,8,11,38,62,0,Matches
331,Julian Brandt,de GER,"MF,FW",Dortmund,de Bundesliga,27-277,1996,14.8,13,11,7,6,0,7,19,36.8,12,12,2,10,7,20,11,0,Matches
332,Jarrad Branthwaite,eng ENG,DF,Everton,eng Premier League,21-221,2002,19,41,21,26,14,1,28,34,82.4,6,24,15,9,33,74,91,1,Matches
333,Darko Brašanac,rs SRB,MF,Osasuna,es La Liga,31-356,1992,0.5,1,0,1,0,0,1,1,100,0,1,0,1,0,1,0,0,Matches
334,Lilian Brassier,fr FRA,DF,Brest,fr Ligue 1,24-093,1999,16.7,19,11,12,7,0,9,15,60,6,15,12,3,29,48,45,0,Matches
335,Claudio Bravo,cl CHI,GK,Betis,es La Liga,40-296,1983,7,0,0,0,0,0,0,1,0,1,0,0,0,0,0,2,0,Matches
336,Tim Breithaupt,de GER,MF,Augsburg,de Bundesliga,21-361,2002,2.9,5,3,4,1,0,4,6,66.7,2,4,2,2,1,6,5,0,Matches
337,Josip Brekalo,hr CRO,FW,Fiorentina,it Serie A,25-225,1998,7.2,8,6,6,2,0,2,11,18.2,9,7,0,7,1,9,0,0,Matches
338,Gleison Bremer,br BRA,DF,Juventus,it Serie A,26-322,1997,21.9,31,22,21,8,2,13,19,68.4,6,24,16,8,27,58,89,0,Matches
339,Brenner,br BRA,FW,Udinese,it Serie A,24-018,2000,0.1,0,0,0,0,0,0,0,,0,1,0,1,0,0,0,0,Matches
340,Ben Brereton,cl CHI,MF,Sheffield Utd,eng Premier League,24-291,1999,1.2,1,1,0,1,0,0,1,0,1,0,0,0,0,1,1,0,Matches
341,Ben Brereton,cl CHI,"FW,MF",Villarreal,es La Liga,24-291,1999,3,2,2,1,0,1,0,2,0,2,0,0,0,0,2,0,0,Matches
342,Marco Brescianini,it ITA,MF,Frosinone,it Serie A,24-014,2000,12.4,16,7,8,7,1,5,17,29.4,12,14,4,10,5,21,19,0,Matches
343,Maximilian Breunig,de GER,FW,Freiburg,de Bundesliga,23-173,2000,0.1,0,0,0,0,0,0,0,,0,1,0,1,0,0,0,0,Matches
344,Rhian Brewster,eng ENG,"FW,MF",Sheffield Utd,eng Premier League,23-308,2000,2.3,4,1,1,1,2,0,1,0,1,1,0,1,0,4,2,0,Matches
345,Armando Broja,al ALB,FW,Chelsea,eng Premier League,22-146,2001,5,3,0,0,1,2,1,2,50,1,5,1,4,0,3,3,0,Matches
346,Dylan Bronn,tn TUN,"DF,MF",Salernitana,it Serie A,28-229,1995,0.6,0,0,0,0,0,0,1,0,1,2,0,2,0,0,4,0,Matches
347,Andre Brooks,eng ENG,"MF,DF",Sheffield Utd,eng Premier League,20-167,2003,5.9,8,6,1,6,1,5,13,38.5,8,8,1,7,9,17,12,0,Matches
348,David Brooks,wls WAL,"FW,MF",Bournemouth,eng Premier League,26-210,1997,3.1,5,4,2,1,2,2,4,50,2,3,0,3,2,7,2,0,Matches
349,John Brooks,us USA,DF,Hoffenheim,de Bundesliga,31-006,1993,13,21,11,14,6,1,10,24,41.7,14,25,15,10,22,43,84,1,Matches
350,Moritz Broschinski,de GER,"FW,MF",Bochum,de Bundesliga,23-133,2000,4.6,5,3,1,2,2,0,2,0,2,1,1,0,0,5,2,0,Matches
351,Jacob Brown,sct SCO,"MF,FW",Luton Town,eng Premier League,25-299,1998,11.2,19,12,7,7,5,7,18,38.9,11,19,1,18,8,27,21,0,Matches
352,Josh Brownhill,eng ENG,MF,Burnley,eng Premier League,28-046,1995,18.7,41,28,14,19,8,17,24,70.8,7,21,4,17,26,67,25,0,Matches
353,Alexander Brunst,de GER,GK,Darmstadt 98,de Bundesliga,28-211,1995,1,0,0,0,0,0,0,0,,0,0,0,0,0,0,0,0,Matches
354,Jacob Bruun Larsen,dk DEN,"MF,FW",Burnley,eng Premier League,25-137,1998,5.1,4,2,2,0,2,3,6,50,3,1,0,1,2,6,6,0,Matches
355,Ante Budimir,hr CRO,FW,Osasuna,es La Liga,32-196,1991,18.1,17,12,2,11,4,3,7,42.9,4,11,4,7,3,20,13,0,Matches
356,Hugo Bueno,es ESP,"DF,MF",Wolves,eng Premier League,21-138,2002,4.4,15,9,8,5,2,7,11,63.6,4,9,1,8,2,17,12,0,Matches
357,Santiago Bueno,uy URU,DF,Wolves,eng Premier League,25-086,1998,2.2,4,2,1,3,0,2,3,66.7,1,6,2,4,2,6,16,0,Matches
358,Marius Bülter,de GER,"FW,DF",Hoffenheim,de Bundesliga,30-311,1993,10.3,10,5,6,3,1,6,14,42.9,8,10,0,10,9,19,18,0,Matches
359,Facundo Buonanotte,ar ARG,"MF,FW",Brighton,eng Premier League,19-042,2004,6.8,17,8,3,10,4,8,19,42.1,11,10,2,8,3,20,2,0,Matches
360,Alessandro Buongiorno,it ITA,DF,Torino,it Serie A,24-242,1999,17.3,46,26,30,13,3,14,24,58.3,10,16,11,5,43,89,79,0,Matches
361,Jonathan Burkardt,de GER,"FW,MF",Mainz 05,de Bundesliga,23-207,2000,3.9,3,2,1,2,0,1,2,50,1,5,2,3,2,5,1,0,Matches
362,Oliver Burke,sct SCO,FW,Werder Bremen,de Bundesliga,26-302,1997,0.4,0,0,0,0,0,0,2,0,2,0,0,0,0,0,0,0,Matches
363,Reece Burke,eng ENG,DF,Luton Town,eng Premier League,27-154,1996,7.6,16,10,8,5,3,5,12,41.7,7,10,6,4,8,24,30,0,Matches
364,Dan Burn,eng ENG,DF,Newcastle Utd,eng Premier League,31-270,1992,15.9,33,16,18,14,1,11,34,32.4,23,27,9,18,24,57,56,1,Matches
365,Rareș-Cătălin Burnete,ro ROU,FW,Lecce,it Serie A,20-003,2004,0.1,0,0,0,0,0,0,0,,0,0,0,0,0,0,0,0,Matches
366,Mason Burstow,eng ENG,FW,Chelsea,eng Premier League,20-183,2003,0.1,0,0,0,0,0,0,0,,0,0,0,0,0,0,0,0,Matches
367,Marnon Busch,de GER,DF,Heidenheim,de Bundesliga,29-057,1994,4.5,7,5,4,2,1,5,9,55.6,4,8,1,7,8,15,9,0,Matches
368,Maxime Busi,be BEL,"FW,DF",Reims,fr Ligue 1,24-112,1999,1.3,1,0,0,1,0,0,2,0,2,4,0,4,2,3,1,0,Matches
369,Pablo Busto,es ESP,DF,Betis,es La Liga,18-141,2005,0.5,1,1,0,0,1,1,1,100,0,0,0,0,1,2,3,0,Matches
370,Aurélio Buta,pt POR,"DF,MF",Eint Frankfurt,de Bundesliga,26-358,1997,11.1,23,14,12,7,4,12,23,52.2,11,15,5,10,7,30,22,0,Matches
371,Marcin Bułka,pl POL,GK,Nice,fr Ligue 1,24-122,1999,19,0,0,0,0,0,0,0,,0,0,0,0,0,0,6,3,Matches
372,Jamie Bynoe-Gittens,eng ENG,"FW,MF",Dortmund,de Bundesliga,19-179,2004,6.2,8,5,4,4,0,2,10,20,8,6,2,4,4,12,7,0,Matches
373,Juan Cabal,co COL,DF,Hellas Verona,it Serie A,23-026,2001,2.5,5,3,2,2,1,4,6,66.7,2,5,2,3,4,9,7,0,Matches
374,Rémy Cabella,fr FRA,"MF,FW",Lille,fr Ligue 1,33-332,1990,10.9,36,25,14,11,11,13,34,38.2,21,17,0,17,4,40,3,0,Matches
375,Jovane Cabral,cv CPV,"MF,FW",Salernitana,it Serie A,25-234,1998,7.5,13,9,4,7,2,3,9,33.3,6,3,0,3,1,14,4,0,Matches
376,Liberato Cacace,nz NZL,DF,Empoli,it Serie A,23-129,2000,13.5,25,14,16,7,2,14,21,66.7,7,11,3,8,11,36,31,0,Matches
377,Anthony Caci,fr FRA,DF,Mainz 05,de Bundesliga,26-217,1997,14.7,24,10,16,8,0,17,26,65.4,9,19,4,15,17,41,24,0,Matches
378,Moisés Caicedo,ec ECU,MF,Chelsea,eng Premier League,22-093,2001,16.9,40,24,19,16,5,14,30,46.7,16,20,11,9,16,56,23,1,Matches
379,Tom Cairney,sct SCO,MF,Fulham,eng Premier League,33-014,1991,11.1,16,10,7,8,1,7,16,43.8,9,11,2,9,11,27,2,0,Matches
380,Jens Cajuste,se SWE,MF,Napoli,it Serie A,24-177,1999,5.8,21,15,9,10,2,13,21,61.9,8,10,2,8,2,23,10,0,Matches
381,Davide Calabria,it ITA,DF,Milan,it Serie A,27-059,1996,16.3,43,22,25,14,4,29,45,64.4,16,16,4,12,20,63,39,0,Matches
382,Riccardo Calafiori,it ITA,DF,Bologna,it Serie A,21-260,2002,16.3,25,18,16,7,2,9,16,56.3,7,23,10,13,32,57,43,2,Matches
383,Luca Caldirola,it ITA,DF,Monza,it Serie A,33-002,1991,19.9,22,12,17,3,2,12,20,60,8,23,14,9,26,48,44,0,Matches
384,Duje Ćaleta-Car,hr CRO,DF,Lyon,fr Ligue 1,27-139,1996,8.1,8,3,6,2,0,6,7,85.7,1,11,5,6,6,14,32,1,Matches
385,Hakan Çalhanoğlu,tr TUR,MF,Inter,it Serie A,29-360,1994,18,41,22,19,16,6,21,35,60,14,17,8,9,9,50,13,0,Matches
386,José Callejón,es ESP,"MF,FW",Granada,es La Liga,36-357,1987,6.9,9,4,6,3,0,6,16,37.5,10,4,1,3,1,10,10,0,Matches
387,Dominic Calvert-Lewin,eng ENG,FW,Everton,eng Premier League,26-324,1997,13.5,7,2,0,4,3,1,10,10,9,7,2,5,1,8,15,0,Matches
388,Lamine Camara,sn SEN,MF,Metz,fr Ligue 1,20-033,2004,13.4,35,23,16,15,4,14,29,48.3,15,18,1,17,16,51,15,0,Matches
389,Mahdi Camara,fr FRA,MF,Brest,fr Ligue 1,25-218,1998,12.6,33,22,6,23,4,16,32,50,16,16,0,16,16,49,11,0,Matches
390,Mohamed Camara,ml MLI,MF,Monaco,fr Ligue 1,24-028,2000,8,22,13,7,11,4,8,18,44.4,10,7,2,5,8,30,4,0,Matches
391,Francesco Camarda,it ITA,FW,Milan,it Serie A,15-330,2008,0.2,0,0,0,0,0,0,2,0,2,0,0,0,0,0,0,0,Matches
392,Eduardo Camavinga,fr FRA,"MF,DF",Real Madrid,es La Liga,21-085,2002,9.8,38,22,17,18,3,14,23,60.9,9,17,3,14,17,55,12,1,Matches
393,Nicolò Cambiaghi,it ITA,"FW,MF",Empoli,it Serie A,23-037,2000,16.5,28,21,8,10,10,7,19,36.8,12,17,1,16,9,37,5,0,Matches
394,Andrea Cambiaso,it ITA,"DF,FW",Juventus,it Serie A,23-348,2000,13.2,21,15,10,7,4,14,23,60.9,9,14,0,14,6,27,17,0,Matches
395,Axel Camblan,fr FRA,FW,Brest,fr Ligue 1,20-157,2003,0.8,1,1,0,0,1,0,2,0,2,2,0,2,0,1,0,0,Matches
396,Sergio Camello,es ESP,FW,Rayo Vallecano,es La Liga,22-358,2001,10.4,9,3,1,7,1,1,3,33.3,2,3,1,2,1,10,10,0,Matches
397,Emre Can,de GER,"MF,DF",Dortmund,de Bundesliga,30-022,1994,12,40,27,25,12,3,18,25,72,7,20,3,17,12,52,20,1,Matches
398,Matteo Cancellieri,it ITA,"FW,MF",Empoli,it Serie A,21-356,2002,12.4,27,17,9,13,5,11,24,45.8,13,16,0,16,3,30,11,0,Matches
399,João Cancelo,pt POR,DF,Barcelona,es La Liga,29-252,1994,15.6,41,27,20,14,7,25,37,67.6,12,23,4,19,12,53,32,1,Matches
400,Fali Candé,gw GNB,DF,Metz,fr Ligue 1,26-010,1998,12.4,25,15,20,5,0,12,20,60,8,24,17,7,13,38,69,0,Matches
401,Antonio Candreva,it ITA,"MF,FW",Salernitana,it Serie A,36-340,1987,18.8,12,9,6,4,2,8,18,44.4,10,4,0,4,5,17,17,0,Matches
402,Thomas Cannon,ie IRL,FW,Everton,eng Premier League,21-037,2002,0,0,0,0,0,0,0,0,,0,0,0,0,0,0,0,0,Matches
403,Sergi Canós,es ESP,"MF,FW",Valencia,es La Liga,27-001,1997,6.4,14,8,5,5,4,3,11,27.3,8,8,1,7,7,21,3,0,Matches
404,Luigi Canotto,it ITA,FW,Frosinone,it Serie A,29-260,1994,0.2,0,0,0,0,0,0,0,,0,0,0,0,0,0,0,0,Matches
405,Gino Caoki,fr FRA,MF,Lorient,fr Ligue 1,19-201,2004,0.1,0,0,0,0,0,0,1,0,1,0,0,0,0,0,0,0,Matches
406,Étienne Capoue,fr FRA,MF,Villarreal,es La Liga,35-207,1988,13,24,15,13,8,3,13,20,65,7,17,4,13,16,40,21,1,Matches
407,Gianluca Caprari,it ITA,"MF,FW",Monza,it Serie A,30-188,1993,2.8,2,1,1,1,0,0,1,0,1,0,0,0,2,4,0,0,Matches
408,Elia Caprile,it ITA,GK,Empoli,it Serie A,22-162,2001,7,1,0,1,0,0,1,1,100,0,0,0,0,0,1,5,1,Matches
409,Francesco Caputo,it ITA,FW,Empoli,it Serie A,36-181,1987,12.2,2,0,0,0,2,0,1,0,1,4,0,4,1,3,2,0,Matches
410,Maxence Caqueret,fr FRA,MF,Lyon,fr Ligue 1,23-353,2000,18.6,45,32,19,18,8,20,58,34.5,38,17,2,15,31,76,15,1,Matches
411,Andrea Carboni,it ITA,DF,Monza,it Serie A,22-364,2001,8.7,24,10,16,8,0,8,13,61.5,5,14,8,6,5,29,31,1,Matches
412,Valentin Carboni,ar ARG,MF,Monza,it Serie A,18-335,2005,5.7,7,4,2,4,1,2,8,25,6,5,0,5,3,10,3,0,Matches
413,Isaac Carcelen,es ESP,DF,Cádiz,es La Liga,30-286,1993,18.4,34,20,23,10,1,16,28,57.1,12,16,3,13,15,49,68,2,Matches
414,Irvin Cardona,fr FRA,"MF,DF",Augsburg,de Bundesliga,26-179,1997,0.6,1,1,0,0,1,1,3,33.3,2,1,0,1,0,1,1,0,Matches
415,Marc Cardona,es ESP,FW,Las Palmas,es La Liga,28-210,1995,4.7,6,5,3,1,2,1,8,12.5,7,5,0,5,1,7,3,0,Matches
416,Sergi Cardona,es ESP,DF,Las Palmas,es La Liga,24-210,1999,19.3,65,39,38,22,5,43,69,62.3,26,29,6,23,33,98,70,0,Matches
417,Johnny Cardoso,us USA,MF,Betis,es La Liga,22-136,2001,1.8,4,3,2,1,1,2,3,66.7,1,3,1,2,3,7,8,0,Matches
418,Igor Carioca,br BRA,"DF,MF",Lorient,fr Ligue 1,27-166,1996,2.9,8,6,6,1,1,4,6,66.7,2,0,0,0,3,11,6,0,Matches
419,Carlos,br BRA,DF,Inter,it Serie A,25-027,1999,9.2,10,8,7,3,0,3,7,42.9,4,12,4,8,9,19,25,0,Matches
420,Diego Carlos,br BRA,DF,Aston Villa,eng Premier League,30-325,1993,10.9,16,11,12,3,1,7,11,63.6,4,9,7,2,7,23,43,1,Matches
421,Carmona,es ESP,"MF,FW",Getafe,es La Liga,22-005,2002,6.7,11,8,3,8,0,2,11,18.2,9,9,0,9,6,17,6,0,Matches
422,Marco Carnesecchi,it ITA,GK,Atalanta,it Serie A,23-217,2000,11,0,0,0,0,0,0,0,,0,0,0,0,0,0,9,1,Matches
423,Yannick Carrasco,be BEL,DF,Atlético Madrid,es La Liga,30-152,1993,2.5,4,4,3,1,0,2,7,28.6,5,2,0,2,1,5,6,0,Matches
424,Álvaro Carreras,es ESP,"MF,FW",Granada,es La Liga,20-317,2003,5.3,13,8,8,4,1,5,11,45.5,6,5,1,4,7,20,9,1,Matches
425,Rasmus Carstensen,dk DEN,"DF,FW",Köln,de Bundesliga,23-115,2000,14,37,16,19,15,3,26,45,57.8,19,29,6,23,16,53,35,2,Matches
426,Antonin Cartillier,fr FRA,DF,Monaco,fr Ligue 1,19-225,2004,0.1,0,0,0,0,0,0,0,,0,1,0,1,0,0,0,0,Matches
427,Dani Carvajal,es ESP,DF,Real Madrid,es La Liga,32-023,1992,15.1,33,20,16,13,4,18,33,54.5,15,14,4,10,20,53,27,1,Matches
428,Fabio Carvalho,pt POR,MF,RB Leipzig,de Bundesliga,21-157,2002,1.8,3,1,0,2,1,1,3,33.3,2,8,0,8,0,3,1,0,Matches
429,William Carvalho,pt POR,MF,Betis,es La Liga,31-302,1992,3.6,12,7,4,7,1,6,7,85.7,1,2,0,2,3,15,3,0,Matches
430,Cesare Casadei,it ITA,MF,Chelsea,eng Premier League,21-024,2003,0.1,0,0,0,0,0,0,0,,0,0,0,0,0,0,0,0,Matches
431,Nicolò Casale,it ITA,DF,Lazio,it Serie A,25-354,1998,8,8,3,8,0,0,6,12,50,6,5,5,0,4,12,28,0,Matches
432,Casemiro,br BRA,MF,Manchester Utd,eng Premier League,31-345,1992,8,26,15,6,16,4,15,34,44.1,19,24,6,18,8,34,19,0,Matches
433,Matty Cash,pl POL,DF,Aston Villa,eng Premier League,26-180,1997,15.2,37,20,17,17,3,19,36,52.8,17,19,6,13,14,51,33,0,Matches
434,Josué Casimir,fr FRA,"DF,FW",Le Havre,fr Ligue 1,22-132,2001,13.6,22,10,10,10,2,5,11,45.5,6,16,2,14,6,28,19,0,Matches
435,Giuseppe Caso,it ITA,"FW,MF",Frosinone,it Serie A,25-056,1998,4.4,4,3,2,0,2,2,3,66.7,1,0,0,0,0,4,0,0,Matches
436,Cristian Cásseres Jr.,ve VEN,MF,Toulouse,fr Ligue 1,24-014,2000,13.2,40,23,18,19,3,16,34,47.1,18,23,2,21,19,59,21,1,Matches
437,Timothy Castagne,be BEL,DF,Fulham,eng Premier League,28-060,1995,15.5,27,11,14,8,5,15,24,62.5,9,17,3,14,28,55,33,1,Matches
438,Koen Casteels,be BEL,GK,Wolfsburg,de Bundesliga,31-223,1992,16,2,1,2,0,0,2,3,66.7,1,0,0,0,0,2,12,2,Matches
439,Valentín Castellanos,ar ARG,FW,Lazio,it Serie A,25-123,1998,9.4,13,8,0,5,8,1,5,20,4,13,2,11,1,14,7,0,Matches
440,Jean-Charles Castelletto,cm CMR,DF,Nantes,fr Ligue 1,29-008,1995,14.6,18,13,9,7,2,11,17,64.7,6,9,7,2,16,34,49,0,Matches
441,Samu Castillejo,es ESP,"FW,MF",Sassuolo,it Serie A,29-016,1995,5.5,12,10,5,5,2,7,17,41.2,10,16,1,15,1,13,3,0,Matches
442,Jonny Castro,es ESP,MF,Wolves,eng Premier League,29-337,1994,0.1,0,0,0,0,0,0,1,0,1,1,1,0,0,0,0,0,Matches
443,Danilo Cataldi,it ITA,MF,Lazio,it Serie A,29-181,1994,8.5,11,2,5,5,1,2,6,33.3,4,9,5,4,11,22,13,1,Matches
444,Catena,es ESP,DF,Osasuna,es La Liga,29-098,1994,16.9,16,9,13,2,1,8,20,40,12,15,10,5,11,27,83,2,Matches
445,Maximiliano Caufriez,be BEL,DF,Clermont Foot,fr Ligue 1,26-352,1997,11.4,22,17,17,4,1,12,19,63.2,7,8,4,4,11,33,52,2,Matches
446,Ivan Cavaleiro,pt POR,FW,Lille,fr Ligue 1,30-108,1993,8.1,9,5,2,4,3,6,18,33.3,12,8,2,6,5,14,5,0,Matches
447,Dani Ceballos,es ESP,MF,Real Madrid,es La Liga,27-180,1996,2.6,4,3,1,3,0,1,4,25,3,4,1,3,0,4,2,0,Matches
448,Emil Ceide,no NOR,"MF,FW",Sassuolo,it Serie A,22-153,2001,1.2,0,0,0,0,0,0,0,,0,3,0,3,0,0,0,0,Matches
449,Zeki Çelik,tr TUR,DF,Roma,it Serie A,26-351,1997,2.6,11,7,4,6,1,5,7,71.4,2,2,1,1,1,12,7,0,Matches
450,Álex Centelles,es ESP,DF,Almería,es La Liga,26-087,1997,2.9,4,2,3,1,0,2,6,33.3,4,2,1,1,5,9,6,0,Matches
451,Fabien Centonze,fr FRA,DF,Nantes,fr Ligue 1,28-018,1996,1,2,1,2,0,0,2,3,66.7,1,2,1,1,0,2,1,0,Matches
452,Václav Černý,cz CZE,"FW,MF",Wolfsburg,de Bundesliga,26-109,1997,8.4,6,3,2,4,0,1,11,9.1,10,12,0,12,6,12,5,0,Matches
453,Michele Cerofolini,it ITA,GK,Frosinone,it Serie A,25-030,1999,1,0,0,0,0,0,0,0,,0,0,0,0,0,0,0,0,Matches
454,Alberto Cerri,it ITA,FW,Empoli,it Serie A,27-293,1996,1.4,1,1,1,0,0,1,1,100,0,1,1,0,2,3,4,0,Matches
455,Franco Cervi,ar ARG,"MF,DF",Celta Vigo,es La Liga,29-253,1994,4.8,17,12,9,7,1,9,19,47.4,10,14,0,14,7,24,4,0,Matches
456,Julio César Enciso,py PAR,MF,Brighton,eng Premier League,20-011,2004,0.8,0,0,0,0,0,0,1,0,1,0,0,0,0,0,0,0,Matches
457,Julian Chabot,de GER,DF,Köln,de Bundesliga,25-356,1998,16.4,35,24,23,12,0,19,29,65.5,10,35,21,14,30,65,73,0,Matches
458,Fares Chaïbi,dz ALG,"FW,MF",Toulouse,fr Ligue 1,21-067,2002,0.6,0,0,0,0,0,0,0,,0,0,0,0,0,0,2,0,Matches
459,Fares Chaïbi,dz ALG,"MF,FW",Eint Frankfurt,de Bundesliga,21-067,2002,10.9,17,10,4,7,6,4,7,57.1,3,23,0,23,2,19,6,0,Matches
460,Muhammed Cham,at AUT,"MF,FW",Clermont Foot,fr Ligue 1,23-130,2000,15.8,16,9,6,8,2,7,17,41.2,10,12,2,10,5,21,3,1,Matches
461,Brendan Chardonnet,fr FRA,DF,Brest,fr Ligue 1,29-043,1994,18,29,18,18,9,2,20,36,55.6,16,32,20,12,26,55,76,2,Matches
462,Charlys,br BRA,MF,Hellas Verona,it Serie A,19-349,2004,0,0,0,0,0,0,0,0,,0,0,0,0,0,0,0,0,Matches
463,Pep Chavarría,es ESP,"DF,MF",Rayo Vallecano,es La Liga,25-299,1998,4.8,7,5,4,3,0,4,4,100,0,6,0,6,3,10,13,0,Matches
464,Jhoanner Chávez,ec ECU,DF,Lens,fr Ligue 1,21-284,2002,1.3,3,2,1,2,0,1,4,25,3,1,0,1,0,3,3,0,Matches
465,Walid Cheddira,ma MAR,FW,Frosinone,it Serie A,26-012,1998,11.1,6,3,1,2,3,1,2,50,1,3,1,2,1,7,7,0,Matches
466,Rayan Cherki,fr FRA,"MF,FW",Lyon,fr Ligue 1,20-170,2003,13.4,16,7,1,11,4,10,29,34.5,19,12,3,9,5,21,0,0,Matches
467,Youssef Chermiti,pt POR,FW,Everton,eng Premier League,19-255,2004,0.6,0,0,0,0,0,0,1,0,1,1,0,1,0,0,0,0,Matches
468,Lucas Chevalier,fr FRA,GK,Lille,fr Ligue 1,22-089,2001,19,1,0,1,0,0,1,2,50,1,1,0,1,0,1,6,2,Matches
469,Fabio Chiarodia,it ITA,"DF,MF",M'Gladbach,de Bundesliga,18-243,2005,0.7,4,2,4,0,0,2,2,100,0,1,1,0,1,5,6,0,Matches
470,Federico Chiesa,it ITA,FW,Juventus,it Serie A,26-101,1997,12.8,9,3,2,3,4,3,5,60,2,8,1,7,5,14,4,0,Matches
471,Ben Chilwell,eng ENG,DF,Chelsea,eng Premier League,27-044,1996,4.4,8,5,1,6,1,1,4,25,3,2,0,2,3,11,7,1,Matches
472,Tawanda Chirewa,eng ENG,FW,Wolves,eng Premier League,20-115,2003,0,2,0,2,0,0,1,1,100,0,0,0,0,1,3,0,0,Matches
473,Pedro Chirivella,es ESP,MF,Nantes,fr Ligue 1,26-256,1997,17.1,28,16,11,16,1,17,44,38.6,27,14,2,12,19,47,16,0,Matches
474,Tahith Chong,nl NED,MF,Luton Town,eng Premier League,24-061,1999,8.6,18,8,12,4,2,7,12,58.3,5,12,2,10,3,21,2,0,Matches
475,Joris Chotard,fr FRA,MF,Montpellier,fr Ligue 1,22-132,2001,17.4,57,37,33,17,7,34,64,53.1,30,33,15,18,26,83,37,0,Matches
476,Andreas Christensen,dk DEN,DF,Barcelona,es La Liga,27-299,1996,12.6,11,7,7,4,0,9,15,60,6,9,4,5,12,23,26,0,Matches
477,Jacob Christensen,dk DEN,"FW,MF",Köln,de Bundesliga,22-223,2001,0.2,1,0,1,0,0,0,0,,0,0,0,0,0,1,0,0,Matches
478,Oliver Christensen,dk DEN,GK,Fiorentina,it Serie A,24-318,1999,2,0,0,0,0,0,0,0,,0,0,0,0,0,0,0,0,Matches
479,Ryan Christie,sct SCO,MF,Bournemouth,eng Premier League,28-346,1995,18.5,48,25,18,18,12,23,50,46,27,25,4,21,28,76,20,0,Matches
480,Carney Chukwuemeka,eng ENG,MF,Chelsea,eng Premier League,20-106,2003,1.7,2,2,1,1,0,1,2,50,1,1,1,0,0,2,0,0,Matches
481,Samuel Chukwueze,ng NGA,FW,Milan,it Serie A,24-257,1999,6.1,14,4,7,5,2,7,14,50,7,2,1,1,4,18,0,0,Matches
482,Víctor Chust,es ESP,DF,Cádiz,es La Liga,23-335,2000,6,9,4,6,3,0,6,9,66.7,3,8,5,3,3,12,23,0,Matches
483,Pathé Ciss,sn SEN,MF,Rayo Vallecano,es La Liga,29-324,1994,11.2,24,11,9,15,0,11,19,57.9,8,17,7,10,21,45,32,0,Matches
484,Ibrahim Cissoko,nl NED,"FW,MF",Toulouse,fr Ligue 1,20-314,2003,2.3,3,2,2,1,0,1,3,33.3,2,2,0,2,1,4,0,0,Matches
485,Giorgio Cittadini,it ITA,DF,Monza,it Serie A,21-291,2002,0.2,1,1,1,0,0,1,1,100,0,1,1,0,0,1,0,0,Matches
486,Patrick Ciurria,it ITA,"DF,MF",Monza,it Serie A,28-359,1995,16.3,29,17,13,12,4,13,20,65,7,17,5,12,9,38,26,0,Matches
487,Bobby Clark,eng ENG,MF,Liverpool,eng Premier League,18-361,2005,0.2,0,0,0,0,0,0,3,0,3,2,0,2,0,0,1,0,Matches
488,Jordan Clark,eng ENG,MF,Luton Town,eng Premier League,30-134,1993,2.5,7,2,4,2,1,2,10,20,8,5,1,4,1,8,4,0,Matches
489,Alexis Claude-Maurice,fr FRA,MF,Nice,fr Ligue 1,25-242,1998,2.2,9,5,3,3,3,1,2,50,1,0,0,0,2,11,4,0,Matches
490,Jonathan Clauss,fr FRA,DF,Marseille,fr Ligue 1,31-131,1992,15.3,32,16,15,13,4,18,34,52.9,16,14,2,12,21,53,35,0,Matches
491,Silvi Clúa,es ESP,MF,Girona,es La Liga,19-005,2005,0,2,0,2,0,0,2,2,100,0,1,0,1,0,2,0,0,Matches
492,Nathaniel Clyne,eng ENG,DF,Crystal Palace,eng Premier League,32-304,1991,8,15,9,7,6,2,9,12,75,3,9,2,7,4,19,21,0,Matches
493,Marcus Coco,fr FRA,DF,Nantes,fr Ligue 1,27-224,1996,10,24,15,15,5,4,13,34,38.2,21,13,1,12,13,37,21,0,Matches
494,Saúl Coco,gq EQG,DF,Las Palmas,es La Liga,24-359,1999,13.4,19,11,15,4,0,7,12,58.3,5,14,12,2,11,30,76,1,Matches
495,Séamus Coleman,ie IRL,DF,Everton,eng Premier League,35-115,1988,2,5,4,4,0,1,3,5,60,2,3,2,1,2,7,10,0,Matches
496,Maxime Colin,fr FRA,DF,Metz,fr Ligue 1,32-080,1991,10.1,23,11,12,6,5,11,19,57.9,8,12,4,8,10,33,37,0,Matches
497,Nathan Collins,ie IRL,DF,Brentford,eng Premier League,22-279,2001,15.1,15,8,10,4,1,7,12,58.3,5,20,11,9,22,37,74,3,Matches
498,Lorenzo Colombo,it ITA,FW,Monza,it Serie A,21-332,2002,13.2,17,12,3,9,5,8,12,66.7,4,15,5,10,0,17,13,0,Matches
499,Andrea Colpani,it ITA,"MF,FW",Monza,it Serie A,24-268,1999,17.5,14,9,2,8,4,4,7,57.1,3,5,2,3,7,21,10,0,Matches
500,Levi Colwill,eng ENG,DF,Chelsea,eng Premier League,20-342,2003,17.8,43,26,21,17,5,24,32,75,8,24,7,17,25,68,50,0,Matches
501,Kingsley Coman,fr FRA,FW,Bayern Munich,de Bundesliga,27-235,1996,11.5,11,6,5,3,3,8,16,50,8,14,1,13,2,13,5,0,Matches
502,Eray Cömert,ch SUI,DF,Nantes,fr Ligue 1,25-364,1998,14.7,25,16,17,8,0,17,23,73.9,6,20,9,11,23,48,55,0,Matches
503,Santi Comesaña,es ESP,MF,Villarreal,es La Liga,27-121,1996,8.1,19,11,5,10,4,10,21,47.6,11,18,5,13,12,31,11,1,Matches
504,Pietro Comuzzo,it ITA,"DF,FW",Fiorentina,it Serie A,18-348,2005,0.1,0,0,0,0,0,0,0,,0,0,0,0,0,0,1,0,Matches
505,Andrea Consigli,it ITA,GK,Sassuolo,it Serie A,37-007,1987,19,0,0,0,0,0,0,0,,0,1,0,1,0,0,12,0,Matches
506,Bambasé Conté,de GER,"FW,MF",Hoffenheim,de Bundesliga,20-211,2003,0,1,1,1,0,0,0,0,,0,0,0,0,0,1,0,0,Matches
507,Nikita Contini Baranovsky,it ITA,GK,Napoli,it Serie A,27-258,1996,0.2,0,0,0,0,0,0,0,,0,0,0,0,0,0,1,0,Matches
508,Lewis Cook,eng ENG,MF,Bournemouth,eng Premier League,27-000,1997,14,28,21,13,15,0,18,33,54.5,15,11,5,6,35,63,20,0,Matches
509,Copete,es ESP,DF,Mallorca,es La Liga,24-116,1999,7.6,21,11,14,7,0,14,18,77.8,4,7,3,4,13,34,27,1,Matches
510,Diego Coppola,it ITA,DF,Hellas Verona,it Serie A,20-037,2003,7,17,9,10,6,1,8,13,61.5,5,10,3,7,10,27,38,1,Matches
511,Francis Coquelin,fr FRA,MF,Villarreal,es La Liga,32-266,1991,2.5,3,2,0,2,1,1,3,33.3,2,6,0,6,6,9,5,0,Matches
512,Tommaso Corazza,it ITA,DF,Bologna,it Serie A,19-219,2004,1.6,8,3,7,1,0,3,7,42.9,4,2,0,2,4,12,2,0,Matches
513,Jeppe Corfitzen,dk DEN,FW,Lecce,it Serie A,19-036,2004,0.1,1,0,0,1,0,1,1,100,0,0,0,0,0,1,0,0,Matches
514,Jack Cork,eng ENG,"MF,DF",Burnley,eng Premier League,34-223,1989,0.2,1,0,0,1,0,1,3,33.3,2,0,0,0,0,1,1,0,Matches
515,Maxwel Cornet,ci CIV,MF,West Ham,eng Premier League,27-129,1996,0.8,2,1,2,0,0,1,5,20,4,0,0,0,1,3,0,0,Matches
516,Giacomo Corona,it ITA,FW,Empoli,it Serie A,19-344,2004,0.1,0,0,0,0,0,0,0,,0,0,0,0,0,0,0,0,Matches
517,Jesús Corona,mx MEX,"MF,DF",Sevilla,es La Liga,31-028,1993,0.2,0,0,0,0,0,0,0,,0,0,0,0,1,1,0,0,Matches
518,Ángel Correa,ar ARG,"FW,MF",Atlético Madrid,es La Liga,28-331,1995,7,6,4,2,3,1,1,8,12.5,7,6,0,6,1,7,0,0,Matches
519,Joaquín Correa,ar ARG,"FW,MF",Marseille,fr Ligue 1,29-174,1994,3.9,4,3,2,1,1,0,8,0,8,2,0,2,1,5,1,0,Matches
520,Thierry Correia,pt POR,DF,Valencia,es La Liga,24-331,1999,15.8,44,28,27,14,3,23,40,57.5,17,20,7,13,28,72,44,0,Matches
521,Oscar Cortés,co COL,"FW,MF",Lens,fr Ligue 1,20-062,2003,0.5,0,0,0,0,0,0,0,,0,1,0,1,0,0,0,0,Matches
522,Danny da Costa,de GER,DF,Mainz 05,de Bundesliga,30-205,1993,8.2,15,7,7,6,2,6,16,37.5,10,15,3,12,15,30,20,0,Matches
523,David Pereira da Costa,pt POR,MF,Lens,fr Ligue 1,23-029,2001,4.9,7,5,2,5,0,4,9,44.4,5,8,3,5,6,13,8,0,Matches
524,Jaume Costa,es ESP,DF,Mallorca,es La Liga,35-322,1988,11.9,28,17,18,6,4,17,24,70.8,7,12,3,9,11,39,18,0,Matches
525,Logan Costa,cv CPV,DF,Toulouse,fr Ligue 1,22-308,2001,16.1,24,16,17,7,0,8,14,57.1,6,29,17,12,10,34,75,0,Matches
526,Samu Costa,pt POR,MF,Mallorca,es La Liga,23-068,2000,18.6,68,38,26,40,2,35,71,49.3,36,23,10,13,27,95,43,3,Matches
527,Benoît Costil,fr FRA,GK,Salernitana,it Serie A,36-215,1987,8,1,1,1,0,0,1,2,50,1,0,0,0,0,1,4,1,Matches
528,Vladimír Coufal,cz CZE,DF,West Ham,eng Premier League,31-165,1992,19.9,43,30,34,7,2,25,46,54.3,21,24,9,15,26,69,61,0,Matches
529,Lassana Coulibaly,ml MLI,MF,Salernitana,it Serie A,27-299,1996,12.2,29,22,14,11,4,16,28,57.1,12,14,2,12,9,38,18,0,Matches
530,Mamadou Coulibaly,sn SEN,DF,Salernitana,it Serie A,25-000,1999,0,0,0,0,0,0,0,0,,0,0,0,0,0,0,0,0,Matches
531,Tanguy Coulibaly,fr FRA,"FW,MF",Montpellier,fr Ligue 1,22-350,2001,1.1,1,1,1,0,0,0,1,0,1,4,0,4,0,1,1,0,Matches
532,Philippe Coutinho,br BRA,"MF,FW",Aston Villa,eng Premier League,31-236,1992,0.3,0,0,0,0,0,0,1,0,1,0,0,0,0,0,0,0,Matches
533,Yan Couto,br BRA,"DF,MF",Girona,es La Liga,21-245,2002,14.8,29,19,16,10,3,12,21,57.1,9,11,2,9,5,34,22,1,Matches
534,Nicolas Cozza,fr FRA,DF,Wolfsburg,de Bundesliga,25-026,1999,3.1,8,6,4,4,0,2,7,28.6,5,3,0,3,4,12,6,0,Matches
535,Alessio Cragno,it ITA,GK,Sassuolo,it Serie A,29-220,1994,2,0,0,0,0,0,0,0,,0,0,0,0,0,0,3,0,Matches
536,Crespo,pt POR,MF,Rayo Vallecano,es La Liga,27-145,1996,0.3,1,1,1,0,0,1,1,100,0,1,1,0,2,3,0,0,Matches
537,Aaron Cresswell,eng ENG,DF,West Ham,eng Premier League,34-050,1989,1.4,1,0,1,0,0,1,1,100,0,2,1,1,0,1,3,0,Matches
538,Bryan Cristante,it ITA,"MF,DF",Roma,it Serie A,28-337,1995,21,40,24,19,16,5,16,29,55.2,13,18,4,14,15,55,41,1,Matches
539,Juan Cruz Armada,es ESP,DF,Osasuna,es La Liga,31-190,1992,13.2,17,10,10,6,1,10,15,66.7,5,11,7,4,6,23,29,1,Matches
540,Juan Cruz,ar ARG,"FW,MF",Hellas Verona,it Serie A,24-199,1999,1.2,2,2,0,0,2,0,0,,0,1,0,1,1,3,0,0,Matches
541,Juan Cruz,es ESP,FW,Betis,es La Liga,23-284,2000,0.8,0,0,0,0,0,0,1,0,1,0,0,0,0,0,0,0,Matches
542,Juan Cuadrado,co COL,DF,Inter,it Serie A,35-253,1988,1.7,3,3,1,2,0,2,3,66.7,1,5,1,4,0,3,1,0,Matches
543,Pau Cubarsí,es ESP,DF,Barcelona,es La Liga,17-012,2007,2.4,6,4,6,0,0,1,1,100,0,3,2,1,2,8,5,0,Matches
544,Marc Cucurella,es ESP,DF,Chelsea,eng Premier League,25-196,1998,7.8,27,17,15,10,2,16,27,59.3,11,17,5,12,12,39,22,0,Matches
545,Jorge Cuenca,es ESP,DF,Villarreal,es La Liga,24-078,1999,13.9,25,19,16,7,2,13,17,76.5,4,21,12,9,15,40,84,0,Matches
546,Josh Cullen,ie IRL,MF,Burnley,eng Premier League,27-302,1996,10.4,16,11,8,7,1,9,18,50,9,19,11,8,7,23,13,0,Matches
547,Matheus Cunha,br BRA,"FW,MF",Wolves,eng Premier League,24-252,1999,20.6,24,11,6,15,3,10,28,35.7,18,22,7,15,13,37,15,1,Matches
548,Marvin Cuni,al ALB,FW,Frosinone,it Serie A,22-208,2001,5.2,5,3,1,2,2,3,4,75,1,9,1,8,1,6,0,0,Matches
549,Eric Curbelo,es ESP,DF,Las Palmas,es La Liga,30-020,1994,1,2,1,1,1,0,1,2,50,1,3,1,2,2,4,5,1,Matches
550,Tomáš Čvančara,cz CZE,FW,M'Gladbach,de Bundesliga,23-174,2000,7.1,2,2,0,2,0,0,1,0,1,3,1,2,0,2,8,0,Matches
551,Danilo D'Ambrosio,it ITA,DF,Monza,it Serie A,35-147,1988,14.2,47,30,29,15,3,23,33,69.7,10,18,11,7,10,57,26,0,Matches
552,Alberto Dadie,es ESP,MF,Real Sociedad,es La Liga,21-198,2002,0.3,2,1,2,0,0,0,0,,0,1,0,1,0,2,0,0,Matches
553,Finn Dahmen,de GER,GK,Augsburg,de Bundesliga,25-313,1998,19,1,0,1,0,0,1,2,50,1,0,0,0,0,1,14,3,Matches
554,Mahmoud Dahoud,de GER,MF,Brighton,eng Premier League,28-033,1996,5,9,4,2,4,3,3,9,33.3,6,4,1,3,1,10,5,0,Matches
555,Ameen Al-Dakhil,be BEL,DF,Burnley,eng Premier League,21-334,2002,11.7,12,5,4,7,1,1,10,10,9,13,6,7,12,24,38,2,Matches
556,Thijs Dallinga,nl NED,FW,Toulouse,fr Ligue 1,23-184,2000,14,15,6,3,5,7,5,9,55.6,4,7,2,5,2,17,20,0,Matches
557,Diogo Dalot,pt POR,DF,Manchester Utd,eng Premier League,24-322,1999,19.3,45,27,33,6,6,29,38,76.3,9,20,6,14,20,65,65,0,Matches
558,Mikkel Damsgaard,dk DEN,MF,Brentford,eng Premier League,23-215,2000,3.5,10,4,5,3,2,5,18,27.8,13,7,1,6,5,15,3,1,Matches
559,Flavius Daniliuc,at AUT,DF,Salernitana,it Serie A,22-282,2001,8.3,19,11,12,5,2,9,19,47.4,10,13,4,9,8,27,15,0,Matches
560,Danilo,br BRA,"MF,FW",Nott'ham Forest,eng Premier League,22-280,2001,9.3,12,5,8,4,0,8,22,36.4,14,14,2,12,16,28,18,0,Matches
561,Danilo,br BRA,DF,Juventus,it Serie A,32-203,1991,15.2,33,22,20,11,2,15,23,65.2,8,18,8,10,24,57,57,0,Matches
562,Arnaut Danjuma,nl NED,"MF,FW",Everton,eng Premier League,27-003,1997,6.6,6,4,2,3,1,1,4,25,3,4,0,4,3,9,0,0,Matches
563,Kevin Danso,at AUT,DF,Lens,fr Ligue 1,25-137,1998,17,12,8,5,7,0,10,18,55.6,8,27,17,10,13,25,70,1,Matches
564,Dante,br BRA,DF,Nice,fr Ligue 1,40-108,1983,19,34,17,25,8,1,23,30,76.7,7,23,11,12,22,56,50,0,Matches
565,Mohammed Daramy,dk DEN,FW,Reims,fr Ligue 1,22-027,2002,13.2,5,4,2,3,0,3,12,25,9,4,1,3,4,9,4,0,Matches
566,Sergi Darder,es ESP,"MF,FW",Mallorca,es La Liga,30-043,1993,15.3,27,19,7,16,4,7,19,36.8,12,14,2,12,14,41,6,0,Matches
567,Achraf Dari,ma MAR,"DF,FW",Brest,fr Ligue 1,24-273,1999,1.3,1,1,1,0,0,0,2,0,2,2,0,2,5,6,9,1,Matches
568,Matteo Darmian,it ITA,DF,Inter,it Serie A,34-063,1989,17,29,13,16,9,4,11,33,33.3,22,21,8,13,9,38,36,0,Matches
569,Lukas Daschner,de GER,"MF,FW",Bochum,de Bundesliga,25-125,1998,3.4,5,3,2,2,1,3,7,42.9,4,6,0,6,2,7,1,0,Matches
570,Josh Dasilva,eng ENG,"DF,FW",Brentford,eng Premier League,25-103,1998,0.3,2,1,0,1,1,0,0,,0,0,0,0,0,2,0,0,Matches
571,David Datro Fofana,ci CIV,FW,Burnley,eng Premier League,21-043,2002,0.4,0,0,0,0,0,0,1,0,1,0,0,0,0,0,0,0,Matches
572,David Datro Fofana,ci CIV,"FW,MF",Union Berlin,de Bundesliga,21-043,2002,7.6,10,7,3,5,2,4,9,44.4,5,4,0,4,0,10,5,0,Matches
573,Jonathan David,ca CAN,FW,Lille,fr Ligue 1,24-020,2000,15.6,10,8,1,6,3,4,15,26.7,11,8,0,8,5,15,0,0,Matches
574,Alphonso Davies,ca CAN,DF,Bayern Munich,de Bundesliga,23-093,2000,14.8,32,15,18,12,2,18,34,52.9,16,20,1,19,18,50,28,1,Matches
575,Ben Davies,wls WAL,DF,Tottenham,eng Premier League,30-285,1993,10,19,15,11,6,2,13,15,86.7,2,16,14,2,9,28,32,0,Matches
576,Tom Davies,eng ENG,MF,Sheffield Utd,eng Premier League,25-218,1998,0.7,4,2,2,2,0,1,3,33.3,2,0,0,0,2,6,2,1,Matches
577,Keinan Davis,eng ENG,FW,Udinese,it Serie A,25-355,1998,0.1,0,0,0,0,0,0,0,,0,0,0,0,0,0,0,0,Matches
578,Paweł Dawidowicz,pl POL,DF,Hellas Verona,it Serie A,28-259,1995,13.3,29,19,18,11,0,8,17,47.1,9,7,4,3,13,42,65,0,Matches
579,Craig Dawson,eng ENG,DF,Wolves,eng Premier League,33-273,1990,19.5,26,17,20,5,1,19,27,70.4,8,38,29,9,12,38,92,1,Matches
580,Kevin De Bruyne,be BEL,MF,Manchester City,eng Premier League,32-220,1991,1.3,2,2,1,0,1,2,2,100,0,0,0,0,0,2,0,0,Matches
581,Charles De Ketelaere,be BEL,"FW,MF",Atalanta,it Serie A,22-330,2001,12,20,13,3,7,10,5,12,41.7,7,16,1,15,4,24,2,0,Matches
582,Rodrigo De Paul,ar ARG,MF,Atlético Madrid,es La Liga,29-255,1994,12.8,22,15,6,11,5,9,22,40.9,13,14,1,13,6,28,11,1,Matches
583,Lorenzo De Silvestri,it ITA,DF,Bologna,it Serie A,35-256,1988,5.8,4,3,3,0,1,2,3,66.7,1,6,3,3,5,9,15,0,Matches
584,Thibault De Smet,be BEL,"DF,FW",Reims,fr Ligue 1,25-243,1998,14.6,43,25,25,14,4,24,42,57.1,18,16,2,14,16,59,35,0,Matches
585,Koni De Winter,be BEL,DF,Genoa,it Serie A,21-236,2002,13.5,22,16,14,7,1,11,15,73.3,4,15,2,13,15,37,38,0,Matches
586,Grégoire Defrel,mq MTQ,"FW,MF",Sassuolo,it Serie A,32-231,1991,2.7,4,1,0,3,1,1,2,50,1,1,0,1,1,5,3,0,Matches
587,Alessandro Deiola,it ITA,MF,Cagliari,it Serie A,28-186,1995,5.5,10,7,5,4,1,7,20,35,13,6,2,4,2,12,4,0,Matches
588,Romain Del Castillo,fr FRA,FW,Brest,fr Ligue 1,27-311,1996,17,22,18,7,8,7,7,37,18.9,30,18,0,18,6,28,4,0,Matches
589,Thomas Delaine,fr FRA,"DF,MF",Strasbourg,fr Ligue 1,31-316,1992,12.2,20,8,14,5,1,15,26,57.7,11,6,2,4,15,35,31,0,Matches
590,Sacha Delaye,fr FRA,"FW,MF",Montpellier,fr Ligue 1,21-286,2002,1.1,5,2,1,1,3,1,5,20,4,1,0,1,0,5,0,0,Matches
591,Hannes Delcroix,be BEL,DF,Burnley,eng Premier League,24-340,1999,4.3,6,3,4,2,0,3,3,100,0,4,1,3,8,14,11,0,Matches
592,Olivier Deman,be BEL,DF,Werder Bremen,de Bundesliga,23-303,2000,10.3,22,13,17,3,2,15,29,51.7,14,21,7,14,9,31,21,0,Matches
593,Karamoko Dembele,sct SCO,"MF,FW",Brest,fr Ligue 1,20-346,2003,0.2,0,0,0,0,0,0,0,,0,0,0,0,0,0,0,0,Matches
594,Ousmane Dembélé,fr FRA,"MF,FW",Paris S-G,fr Ligue 1,26-264,1997,11.9,13,10,2,5,6,3,7,42.9,4,9,0,9,4,17,3,1,Matches
595,Jessy Deminguet,fr FRA,"MF,FW",Strasbourg,fr Ligue 1,26-027,1998,6.7,12,8,6,6,0,5,15,33.3,10,7,0,7,7,19,4,0,Matches
596,Ermedin Demirović,ba BIH,"MF,FW",Augsburg,de Bundesliga,25-315,1998,18.2,16,9,5,10,1,8,26,30.8,18,16,1,15,7,23,16,0,Matches
597,Diego Demme,de GER,MF,Napoli,it Serie A,32-074,1991,0.8,1,1,0,1,0,0,1,0,1,0,0,0,0,1,0,0,Matches
598,Sepp van den Berg,nl NED,DF,Mainz 05,de Bundesliga,22-045,2001,15.5,27,15,13,12,2,9,14,64.3,5,33,13,20,22,49,66,1,Matches
599,Leander Dendoncker,be BEL,MF,Aston Villa,eng Premier League,28-294,1995,1.3,6,4,3,2,1,4,5,80,1,5,2,3,2,8,3,1,Matches
600,Leander Dendoncker,be BEL,MF,Napoli,it Serie A,28-294,1995,0.1,0,0,0,0,0,0,0,,0,1,1,0,0,0,0,0,Matches
601,Rémy Descamps,fr FRA,GK,Nantes,fr Ligue 1,27-223,1996,5,0,0,0,0,0,0,0,,0,0,0,0,0,0,6,0,Matches
602,Mikkel Desler,dk DEN,DF,Toulouse,fr Ligue 1,28-349,1995,11.9,13,8,6,6,1,6,11,54.5,5,22,9,13,10,23,29,0,Matches
603,Arthur Desmas,fr FRA,GK,Le Havre,fr Ligue 1,29-302,1994,19,0,0,0,0,0,0,1,0,1,0,0,0,0,0,8,0,Matches
604,Mattia Destro,it ITA,"FW,MF",Empoli,it Serie A,32-320,1991,2.1,0,0,0,0,0,0,0,,0,0,0,0,2,2,2,0,Matches
605,Samuele Di Benedetto,de GER,MF,Stuttgart,de Bundesliga,18-202,2005,0.1,0,0,0,0,0,0,0,,0,0,0,0,1,1,0,0,Matches
606,Federico Di Francesco,it ITA,"FW,MF",Lecce,it Serie A,29-234,1994,0.2,1,0,0,1,0,0,0,,0,0,0,0,0,1,0,0,Matches
607,Michele Di Gregorio,it ITA,GK,Monza,it Serie A,26-191,1997,18.4,1,0,1,0,0,1,2,50,1,0,0,0,1,2,9,1,Matches
608,Giovanni Di Lorenzo,it ITA,DF,Napoli,it Serie A,30-183,1993,21,36,23,21,12,3,22,45,48.9,23,25,7,18,12,48,32,0,Matches
609,Alessandro Di Pardo,it ITA,"DF,MF",Cagliari,it Serie A,24-200,1999,2.3,3,1,2,0,1,0,2,0,2,5,2,3,3,6,3,0,Matches
610,Boulaye Dia,sn SEN,"FW,MF",Salernitana,it Serie A,27-079,1996,10.5,4,2,2,2,0,1,3,33.3,2,5,0,5,3,7,7,0,Matches
611,Moussa Diaby,fr FRA,"FW,MF",Aston Villa,eng Premier League,24-211,1999,15.7,7,2,2,4,1,3,10,30,7,5,0,5,5,12,4,0,Matches
612,Lamine Diack,sn SEN,MF,Nantes,fr Ligue 1,23-080,2000,0,0,0,0,0,0,0,0,,0,0,0,0,0,0,0,0,Matches
613,Mouctar Diakhaby,gn GUI,"DF,MF",Valencia,es La Liga,27-046,1996,9.9,17,11,8,9,0,11,13,84.6,2,17,7,10,8,25,55,0,Matches
614,Mamadou Diakhon,fr FRA,FW,Reims,fr Ligue 1,18-134,2005,1.6,2,1,1,1,0,2,6,33.3,4,0,0,0,1,3,1,0,Matches
615,Bafodé Diakité,fr FRA,DF,Lille,fr Ligue 1,23-028,2001,8.7,21,15,7,13,1,16,20,80,4,10,5,5,12,33,22,0,Matches
616,Ibrahim Diakité,gn GUI,DF,Reims,fr Ligue 1,20-095,2003,1.2,1,0,0,1,0,0,1,0,1,3,0,3,2,3,5,0,Matches
617,Moussa Diakité,ml MLI,MF,Cádiz,es La Liga,20-091,2003,0,0,0,0,0,0,0,0,,0,0,0,0,0,0,0,0,Matches
618,Oumar Diakité,ci CIV,FW,Reims,fr Ligue 1,20-045,2003,6.7,9,5,6,2,1,3,11,27.3,8,6,0,6,3,12,4,0,Matches
619,Amad Diallo,ci CIV,FW,Manchester Utd,eng Premier League,21-207,2002,0.4,1,1,0,1,0,0,0,,0,0,0,0,0,1,0,0,Matches
620,Amadou Diallo,eng ENG,MF,Newcastle Utd,eng Premier League,20-353,2003,0,0,0,0,0,0,0,0,,0,0,0,0,0,0,0,0,Matches
621,Assane Diao,es ESP,FW,Betis,es La Liga,18-149,2005,10.6,18,11,5,7,6,5,15,33.3,10,20,4,16,7,25,7,0,Matches
622,Mouhamadou Diarra,fr FRA,"MF,FW",Strasbourg,fr Ligue 1,20-031,2004,14.4,12,9,3,9,0,2,18,11.1,16,15,4,11,11,23,7,0,Matches
623,Moussa Diarra,ml MLI,DF,Toulouse,fr Ligue 1,23-085,2000,8.4,18,6,9,8,1,8,17,47.1,9,19,10,9,13,31,27,0,Matches
624,Rúben Dias,pt POR,DF,Manchester City,eng Premier League,26-265,1997,15.4,19,9,6,12,1,9,15,60,6,19,9,10,15,34,51,0,Matches
625,Krépin Diatta,sn SEN,"DF,MF",Monaco,fr Ligue 1,24-343,1999,7,15,10,6,8,1,12,25,48,13,11,1,10,8,23,9,0,Matches
626,Mory Diaw,sn SEN,GK,Clermont Foot,fr Ligue 1,30-226,1993,17,0,0,0,0,0,0,0,,0,0,0,0,1,1,6,2,Matches
627,Mahamadou Diawara,fr FRA,MF,Lyon,fr Ligue 1,18-351,2005,3.8,8,5,4,4,0,3,10,30,7,4,1,3,3,11,4,0,Matches
628,Brahim Díaz,es ESP,"MF,FW",Real Madrid,es La Liga,24-184,1999,7.2,10,7,1,8,1,4,9,44.4,5,6,0,6,2,12,0,0,Matches
629,Luis Díaz,co COL,FW,Liverpool,eng Premier League,27-021,1997,14.5,15,11,2,7,6,4,19,21.1,15,9,0,9,2,17,3,0,Matches
630,Víctor Díaz,es ESP,"DF,MF",Granada,es La Liga,35-236,1988,1.8,5,3,2,3,0,1,3,33.3,2,1,0,1,1,6,8,0,Matches
631,Famara Diedhiou,sn SEN,"FW,MF",Granada,es La Liga,31-050,1992,1,1,1,0,1,0,0,1,0,1,0,0,0,0,1,2,0,Matches
632,Justin Diehl,de GER,"FW,MF",Köln,de Bundesliga,19-068,2004,0.8,0,0,0,0,0,0,0,,0,1,1,0,0,0,0,0,Matches
633,Bamba Dieng,sn SEN,FW,Lorient,fr Ligue 1,23-317,2000,4.3,2,2,0,2,0,1,2,50,1,1,0,1,0,2,5,0,Matches
634,Eric Dier,eng ENG,DF,Tottenham,eng Premier League,30-019,1994,2.2,2,1,2,0,0,2,2,100,0,3,3,0,2,4,12,0,Matches
635,Eric Dier,eng ENG,DF,Bayern Munich,de Bundesliga,30-019,1994,1.5,0,0,0,0,0,0,0,,0,0,0,0,2,2,6,0,Matches
636,Guillaume Dietsch,fr FRA,GK,Metz,fr Ligue 1,22-292,2001,0.8,0,0,0,0,0,0,0,,0,0,0,0,0,0,0,0,Matches
637,Florian Dietz,de GER,FW,Köln,de Bundesliga,25-184,1998,0.5,0,0,0,0,0,0,0,,0,1,0,1,0,0,0,0,Matches
638,Lucas Digne,fr FRA,DF,Aston Villa,eng Premier League,30-198,1993,16.9,30,13,23,6,1,17,29,58.6,12,10,0,10,19,49,37,0,Matches
639,Federico Dimarco,it ITA,DF,Inter,it Serie A,26-085,1997,12.7,24,16,9,11,4,12,24,50,12,12,2,10,7,31,22,1,Matches
640,Stole Dimitrievski,mk MKD,GK,Rayo Vallecano,es La Liga,30-040,1993,22,0,0,0,0,0,0,0,,0,0,0,0,0,0,10,3,Matches
641,Junior Dina Ebimbe,fr FRA,"MF,DF",Eint Frankfurt,de Bundesliga,23-074,2000,13.2,23,14,7,10,6,9,23,39.1,14,20,6,14,4,27,23,0,Matches
642,Eren Dinkçi,de GER,"FW,MF",Heidenheim,de Bundesliga,22-052,2001,16.6,18,9,11,6,1,10,25,40,15,19,2,17,5,23,15,0,Matches
643,Sinaly Diomande,ci CIV,DF,Lyon,fr Ligue 1,22-300,2001,9.9,10,4,5,3,2,9,16,56.3,7,12,9,3,15,25,26,1,Matches
644,Edan Diop,fr FRA,"MF,DF",Monaco,fr Ligue 1,19-159,2004,1.3,5,5,3,1,1,2,3,66.7,1,1,0,1,1,6,3,0,Matches
645,Issa Diop,fr FRA,DF,Fulham,eng Premier League,27-025,1997,10.7,15,9,10,4,1,7,11,63.6,4,15,10,5,11,26,54,1,Matches
646,Sofiane Diop,fr FRA,FW,Nice,fr Ligue 1,23-239,2000,5.5,8,6,3,4,1,4,10,40,6,4,0,4,3,11,3,0,Matches
647,Andy Diouf,fr FRA,MF,Lens,fr Ligue 1,20-262,2003,9.9,20,13,9,9,2,12,18,66.7,6,10,1,9,3,23,3,0,Matches
648,Yehvann Diouf,fr FRA,GK,Reims,fr Ligue 1,24-079,1999,19,0,0,0,0,0,0,0,,0,0,0,0,0,0,11,1,Matches
649,Axel Disasi,fr FRA,DF,Chelsea,eng Premier League,25-329,1998,19.7,22,12,11,8,3,14,18,77.8,4,17,12,5,11,33,66,1,Matches
650,Chaim El Djebali,tn TUN,MF,Lyon,fr Ligue 1,19-361,2004,0.1,0,0,0,0,0,0,0,,0,0,0,0,0,0,0,0,Matches
651,Djené,tg TOG,"MF,DF",Getafe,es La Liga,32-034,1991,15.2,17,9,7,9,1,6,12,50,6,17,6,11,14,31,36,0,Matches
652,Koffi Djidji,ci CIV,DF,Torino,it Serie A,31-065,1992,2.5,4,3,2,2,0,2,2,100,0,5,3,2,5,9,11,0,Matches
653,Berat Djimsiti,al ALB,DF,Atalanta,it Serie A,30-349,1993,19,19,14,11,8,0,4,11,36.4,7,37,22,15,37,56,55,0,Matches
654,Marko Dmitrović,rs SRB,GK,Sevilla,es La Liga,32-010,1992,13,1,1,1,0,0,1,2,50,1,0,0,0,1,2,5,0,Matches
655,Ben Doak,sct SCO,FW,Liverpool,eng Premier League,18-084,2005,0.2,0,0,0,0,0,0,0,,0,0,0,0,0,0,0,0,Matches
656,Ritsu Doan,jp JPN,"MF,FW",Freiburg,de Bundesliga,25-232,1998,11.8,23,13,11,8,4,9,17,52.9,8,11,1,10,3,26,14,0,Matches
657,Lewis Dobbin,eng ENG,MF,Everton,eng Premier League,21-031,2003,1.9,5,4,3,1,1,3,7,42.9,4,4,1,3,1,6,0,0,Matches
658,Dodô,br BRA,DF,Fiorentina,it Serie A,25-078,1998,3,3,2,1,2,0,1,4,25,3,2,0,2,3,6,6,0,Matches
659,Danilho Doekhi,nl NED,DF,Union Berlin,de Bundesliga,25-218,1998,8,14,10,9,5,0,5,9,55.6,4,13,3,10,15,29,25,0,Matches
660,Matt Doherty,ie IRL,"DF,MF",Wolves,eng Premier League,32-018,1992,6.3,13,7,6,5,2,5,11,45.5,6,6,2,4,3,16,21,0,Matches
661,Josh Doig,sct SCO,DF,Hellas Verona,it Serie A,21-261,2002,9.2,16,9,9,7,0,13,17,76.5,4,12,3,9,4,20,17,1,Matches
662,Josh Doig,sct SCO,DF,Sassuolo,it Serie A,21-261,2002,1,2,2,2,0,0,2,5,40,3,3,1,2,1,3,2,0,Matches
663,Jeremy Doku,be BEL,"FW,DF",Manchester City,eng Premier League,21-252,2002,9.6,24,16,8,9,7,8,15,53.3,7,6,0,6,7,31,3,0,Matches
664,Jeremy Doku,be BEL,FW,Rennes,fr Ligue 1,21-252,2002,1.2,2,2,1,0,1,1,1,100,0,0,0,0,0,2,0,0,Matches
665,Carlos Dominguez,es ESP,DF,Celta Vigo,es La Liga,22-357,2001,8.5,18,10,5,9,4,12,19,63.2,7,11,4,7,17,35,33,0,Matches
666,Mario Dominguez,es ESP,FW,Valencia,es La Liga,19-358,2004,0.3,0,0,0,0,0,0,0,,0,0,0,0,0,0,0,0,Matches
667,Nicolás Domínguez,ar ARG,"MF,FW",Nott'ham Forest,eng Premier League,25-220,1998,9.9,34,20,19,14,1,14,24,58.3,10,12,2,10,7,41,17,0,Matches
668,Nicolás Domínguez,ar ARG,MF,Bologna,it Serie A,25-220,1998,1.1,1,0,1,0,0,0,2,0,2,3,0,3,0,1,2,0,Matches
669,Giulio Donati,it ITA,DF,Monza,it Serie A,33-363,1990,0.1,0,0,0,0,0,0,0,,0,0,0,0,0,0,0,0,Matches
670,Jamie Donley,eng ENG,FW,Tottenham,eng Premier League,19-031,2005,0,0,0,0,0,0,0,0,,0,0,0,0,0,0,3,0,Matches
671,Gianluigi Donnarumma,it ITA,GK,Paris S-G,fr Ligue 1,24-343,1999,17.1,0,0,0,0,0,0,0,,0,0,0,0,1,1,4,4,Matches
672,Patrick Dorgu,dk DEN,DF,Lecce,it Serie A,19-100,2004,8.2,24,14,17,6,1,13,18,72.2,5,9,3,6,6,30,23,2,Matches
673,Niklas Dorsch,de GER,MF,Augsburg,de Bundesliga,26-019,1998,12.7,29,21,11,18,0,11,27,40.7,16,11,8,3,14,43,22,0,Matches
674,Gabriel Dos Santos,br BRA,DF,Arsenal,eng Premier League,26-046,1997,18.2,22,10,12,9,1,11,13,84.6,2,29,21,8,17,39,49,0,Matches
675,Alberto Dossena,it ITA,DF,Cagliari,it Serie A,25-113,1998,21.1,40,27,34,6,0,23,34,67.6,11,35,20,15,31,71,115,2,Matches
676,Carlos Dotor,es ESP,MF,Celta Vigo,es La Liga,22-325,2001,7.7,14,7,3,8,3,4,13,30.8,9,12,2,10,4,18,3,0,Matches
677,Abdoulaye Doucouré,ml MLI,"FW,MF",Everton,eng Premier League,31-033,1993,17,28,18,12,11,5,12,27,44.4,15,16,2,14,12,40,10,0,Matches
678,Cheick Doucouré,ml MLI,MF,Crystal Palace,eng Premier League,24-026,2000,10.2,34,17,15,13,6,18,30,60,12,13,2,11,20,54,12,0,Matches
679,Siriné Doucouré,ml MLI,FW,Lorient,fr Ligue 1,21-301,2002,4.7,8,6,0,4,4,3,3,100,0,4,0,4,1,9,6,0,Matches
680,Désiré Doué,fr FRA,"MF,FW",Rennes,fr Ligue 1,18-245,2005,7.4,16,8,5,6,5,4,15,26.7,11,15,0,15,6,22,3,0,Matches
681,Guela Doué,fr FRA,DF,Rennes,fr Ligue 1,21-109,2002,4.2,7,6,2,4,1,5,12,41.7,7,3,1,2,6,13,17,0,Matches
682,Alfie Doughty,eng ENG,"DF,MF",Luton Town,eng Premier League,24-044,1999,16.6,35,23,16,12,7,20,40,50,20,23,1,22,17,52,27,1,Matches
683,Douglas,br BRA,MF,Nantes,fr Ligue 1,27-021,1997,12.6,49,31,18,26,5,17,35,48.6,18,18,7,11,21,70,19,0,Matches
684,Ismaël Doukouré,fr FRA,"MF,DF",Strasbourg,fr Ligue 1,20-194,2003,12.9,18,13,4,13,1,12,16,75,4,12,5,7,17,35,12,2,Matches
685,Kamory Doumbia,ml MLI,MF,Brest,fr Ligue 1,20-350,2003,4,11,8,0,4,7,4,12,33.3,8,11,0,11,3,14,3,0,Matches
686,Anastasios Douvikas,gr GRE,FW,Celta Vigo,es La Liga,24-185,1999,6,8,5,1,3,4,0,5,0,5,2,1,1,1,9,6,0,Matches
687,Artem Dovbyk,ua UKR,FW,Girona,es La Liga,26-227,1997,14.8,3,2,2,0,1,0,1,0,1,6,1,5,0,3,15,0,Matches
688,Nikola Dovedan,at AUT,"MF,FW",Heidenheim,de Bundesliga,29-212,1994,2.8,8,6,1,7,0,3,9,33.3,6,4,0,4,0,8,1,0,Matches
689,Damion Downs,de GER,"FW,MF",Köln,de Bundesliga,19-212,2004,0.3,0,0,0,0,0,0,0,,0,0,0,0,0,0,0,0,Matches
690,Tommy Doyle,eng ENG,MF,Wolves,eng Premier League,22-109,2001,6.5,12,5,7,4,1,6,9,66.7,3,12,6,6,7,19,10,0,Matches
691,Radu Drăgușin,ro ROU,"MF,DF",Tottenham,eng Premier League,22-000,2002,0.1,0,0,0,0,0,0,0,,0,0,0,0,1,1,2,0,Matches
692,Radu Drăgușin,ro ROU,DF,Genoa,it Serie A,22-000,2002,19,16,11,9,6,1,8,9,88.9,1,18,12,6,21,37,87,3,Matches
693,Dion Drena Beljo,hr CRO,"FW,MF",Augsburg,de Bundesliga,21-339,2002,4.9,0,0,0,0,0,0,1,0,1,6,1,5,1,1,3,0,Matches
694,Domingos Duarte,pt POR,DF,Getafe,es La Liga,28-330,1995,8.9,7,4,6,0,1,5,7,71.4,2,6,5,1,6,13,24,0,Matches
695,Rubén Duarte,es ESP,DF,Alavés,es La Liga,28-108,1995,13,26,17,16,8,2,10,17,58.8,7,11,2,9,16,42,41,0,Matches
696,Martin Dúbravka,sk SVK,GK,Newcastle Utd,eng Premier League,35-019,1989,8.1,0,0,0,0,0,0,2,0,2,0,0,0,0,0,2,0,Matches
697,Marvin Ducksch,de GER,FW,Werder Bremen,de Bundesliga,29-333,1994,15.9,6,2,4,2,0,4,9,44.4,5,0,0,0,2,8,14,0,Matches
698,Ondrej Duda,sk SVK,MF,Hellas Verona,it Serie A,29-060,1994,15.5,33,20,9,21,3,18,34,52.9,16,18,5,13,15,48,12,0,Matches
699,Denzel Dumfries,nl NED,DF,Inter,it Serie A,27-291,1996,11.5,16,11,5,10,1,5,15,33.3,10,13,4,9,6,22,19,0,Matches
700,Paul Dummett,wls WAL,DF,Newcastle Utd,eng Premier League,32-130,1991,0.1,1,0,1,0,0,1,1,100,0,0,0,0,0,1,0,0,Matches
701,Alfred Duncan,gh GHA,MF,Fiorentina,it Serie A,30-330,1993,14.2,23,14,8,11,4,11,25,44,14,20,4,16,8,31,7,0,Matches
702,Lewis Dunk,eng ENG,DF,Brighton,eng Premier League,32-074,1991,17.7,16,9,9,6,1,7,22,31.8,15,33,25,8,15,31,40,1,Matches
703,Jhon Durán,co COL,"FW,MF",Aston Villa,eng Premier League,20-052,2003,2.1,3,3,1,1,1,0,3,0,3,3,0,3,0,3,7,0,Matches
704,Hugo Duro,es ESP,FW,Valencia,es La Liga,24-085,1999,20,10,6,2,5,3,5,19,26.3,14,15,3,12,1,11,16,0,Matches
705,Jean-Kevin Duverne,ht HAI,DF,Nantes,fr Ligue 1,26-206,1997,11,29,17,13,13,3,15,35,42.9,20,12,5,7,15,44,23,0,Matches
706,Paulo Dybala,ar ARG,"FW,MF",Roma,it Serie A,30-080,1993,12.2,16,10,3,5,8,1,8,12.5,7,7,0,7,2,18,2,0,Matches
707,Aron Dønnum,no NOR,"FW,MF",Toulouse,fr Ligue 1,25-289,1998,11.2,7,5,2,3,2,3,13,23.1,10,10,0,10,5,12,12,1,Matches
708,Festy Ebosele,ie IRL,DF,Udinese,it Serie A,21-185,2002,15.8,26,16,19,6,1,18,31,58.1,13,24,1,23,6,32,24,0,Matches
709,Enzo Ebosse,cm CMR,DF,Udinese,it Serie A,24-329,1999,0.1,1,1,1,0,0,0,1,0,1,0,0,0,1,2,0,0,Matches
710,Tyronne Ebuehi,ng NGA,DF,Empoli,it Serie A,28-049,1995,11.9,14,9,9,5,0,7,11,63.6,4,9,4,5,6,20,27,0,Matches
711,Ederson,br BRA,GK,Manchester City,eng Premier League,30-170,1993,19.1,0,0,0,0,0,0,1,0,1,0,0,0,0,0,2,1,Matches
712,Éderson,br BRA,MF,Atalanta,it Serie A,24-211,1999,19.5,54,36,20,27,7,31,42,73.8,11,27,3,24,28,82,16,1,Matches
713,Odsonne Édouard,fr FRA,FW,Crystal Palace,eng Premier League,26-018,1998,13.8,17,10,5,5,7,3,13,23.1,10,13,1,12,5,22,15,0,Matches
714,John Egan,ie IRL,DF,Sheffield Utd,eng Premier League,31-106,1992,5.4,6,4,4,2,0,4,11,36.4,7,10,4,6,13,19,39,1,Matches
715,Maximilian Eggestein,de GER,MF,Freiburg,de Bundesliga,27-057,1996,18.5,23,10,12,8,3,4,16,25,12,30,13,17,18,41,27,0,Matches
716,Lilian Egloff,de GER,"MF,DF",Stuttgart,de Bundesliga,21-167,2002,1.2,4,1,3,1,0,2,4,50,2,3,1,2,1,5,0,0,Matches
717,Kingsley Ehizibue,nl NED,DF,Udinese,it Serie A,28-254,1995,1.9,4,3,3,1,0,2,2,100,0,2,0,2,2,6,2,0,Matches
718,Hjalmar Ekdal,se SWE,DF,Burnley,eng Premier League,25-105,1998,3.1,2,1,1,1,0,0,1,0,1,4,2,2,4,6,15,0,Matches
719,Hugo Ekitike,fr FRA,FW,Paris S-G,fr Ligue 1,21-228,2002,0.1,0,0,0,0,0,0,0,,0,0,0,0,0,0,0,0,Matches
720,Emmanuel Ekong,se SWE,FW,Empoli,it Serie A,21-223,2002,0.1,0,0,0,0,0,0,0,,0,0,0,0,0,0,0,0,Matches
721,Caleb Ekuban,gh GHA,FW,Genoa,it Serie A,29-317,1994,6.9,6,3,1,3,2,3,5,60,2,9,2,7,0,6,6,0,Matches
722,Anthony Elanga,se SWE,"FW,MF",Nott'ham Forest,eng Premier League,21-282,2002,15.3,19,12,12,4,3,8,18,44.4,10,17,2,15,7,26,9,0,Matches
723,Simon Elisor,fr FRA,FW,Metz,fr Ligue 1,24-196,1999,8.5,9,2,3,2,4,2,6,33.3,4,6,1,5,0,9,9,0,Matches
724,Harvey Elliott,eng ENG,"MF,FW",Liverpool,eng Premier League,20-305,2003,5.5,13,10,3,7,3,6,15,40,9,7,0,7,2,15,4,0,Matches
725,Elif Elmas,mk MKD,"FW,MF",Napoli,it Serie A,24-132,1999,3.8,4,3,1,3,0,2,2,100,0,2,0,2,2,6,8,0,Matches
726,Elif Elmas,mk MKD,"MF,DF",RB Leipzig,de Bundesliga,24-132,1999,0.3,3,1,1,1,1,3,3,100,0,1,0,1,0,3,0,0,Matches
727,Mohamed Elneny,eg EGY,MF,Arsenal,eng Premier League,31-207,1992,0,0,0,0,0,0,0,0,,0,0,0,0,1,1,0,0,Matches
728,Aritz Elustondo,es ESP,DF,Real Sociedad,es La Liga,29-312,1994,5.5,6,4,1,4,1,5,8,62.5,3,6,5,1,5,11,15,0,Matches
729,Nico Elvedi,ch SUI,DF,M'Gladbach,de Bundesliga,27-126,1996,14.9,20,9,15,4,1,13,16,81.3,3,19,12,7,20,40,80,1,Matches
730,Adri Embarba,es ESP,"FW,MF",Almería,es La Liga,31-272,1992,15.2,32,20,18,6,8,13,30,43.3,17,16,0,16,9,41,4,0,Matches
731,Emanuel Emegha,nl NED,FW,Strasbourg,fr Ligue 1,21-000,2003,12.3,3,2,2,0,1,3,6,50,3,8,2,6,2,5,14,0,Matches
732,Emerson,br BRA,DF,Tottenham,eng Premier League,25-020,1999,8.7,24,17,17,7,0,15,30,50,15,13,6,7,14,38,41,1,Matches
733,Youssef En-Nesyri,ma MAR,FW,Sevilla,es La Liga,26-247,1997,13.3,5,3,0,3,2,0,2,0,2,3,0,3,3,8,8,0,Matches
734,Wataru Endo,jp JPN,MF,Liverpool,eng Premier League,30-359,1993,7.8,16,11,5,9,2,7,22,31.8,15,9,0,9,9,25,16,1,Matches
735,Arne Engels,be BEL,"MF,DF",Augsburg,de Bundesliga,20-148,2003,8.9,15,10,2,10,3,7,19,36.8,12,17,1,16,6,21,10,0,Matches
736,Christian Eriksen,dk DEN,MF,Manchester Utd,eng Premier League,31-354,1992,9.4,13,11,4,7,2,7,24,29.2,17,14,5,9,3,16,9,0,Matches
737,Martin Erlic,hr CRO,DF,Sassuolo,it Serie A,26-010,1998,18.3,26,14,21,3,2,14,20,70,6,18,10,8,19,45,82,1,Matches
738,Gonzalo Escalante,ar ARG,MF,Cádiz,es La Liga,30-313,1993,10.3,28,17,12,10,6,15,32,46.9,17,10,3,7,15,43,18,1,Matches
739,Alfonso Espino,uy URU,DF,Rayo Vallecano,es La Liga,32-029,1992,18.9,49,32,29,18,2,21,56,37.5,35,12,1,11,23,72,40,0,Matches
740,Bernardo Espinosa,co COL,DF,Girona,es La Liga,34-207,1989,0,1,1,1,0,0,1,1,100,0,0,0,0,0,1,2,0,Matches
741,Maxime Estève,fr FRA,DF,Montpellier,fr Ligue 1,21-253,2002,11.1,16,12,11,5,0,10,15,66.7,5,13,9,4,18,34,50,0,Matches
742,Oscar Estupiñan,co COL,FW,Metz,fr Ligue 1,27-036,1996,2.9,5,4,0,3,2,1,2,50,1,2,0,2,0,5,0,0,Matches
743,Pervis Estupiñán,ec ECU,DF,Brighton,eng Premier League,26-013,1998,8.3,13,7,6,6,1,8,15,53.3,7,9,2,7,13,26,10,0,Matches
744,Karl Etta,cm CMR,FW,Cádiz,es La Liga,20-033,2004,0.2,1,1,0,1,0,0,0,,0,0,0,0,0,1,0,0,Matches
745,Jonny Evans,nir NIR,DF,Manchester Utd,eng Premier League,36-031,1988,9.8,8,4,6,2,0,6,13,46.2,7,11,8,3,11,19,45,0,Matches
746,Eberechi Eze,eng ENG,"MF,FW",Crystal Palace,eng Premier League,25-219,1998,12.9,23,9,1,11,11,10,21,47.6,11,10,1,9,5,28,4,0,Matches
747,Abdessamad Ezzalzouli,ma MAR,"FW,MF",Barcelona,es La Liga,22-048,2001,0.8,1,1,0,0,1,0,1,0,1,1,0,1,0,1,0,0,Matches
748,Abdessamad Ezzalzouli,ma MAR,FW,Betis,es La Liga,22-048,2001,5.6,7,6,1,4,2,3,6,50,3,5,0,5,4,11,0,0,Matches
749,Giovanni Fabbian,it ITA,"MF,FW",Bologna,it Serie A,21-020,2003,4.9,8,3,4,4,0,2,5,40,3,0,0,0,2,10,6,0,Matches
750,Łukasz Fabiański,pl POL,GK,West Ham,eng Premier League,38-291,1985,3,1,0,1,0,0,1,1,100,0,0,0,0,1,2,0,0,Matches
751,Nicolò Fagioli,it ITA,MF,Juventus,it Serie A,22-356,2001,3.8,4,2,1,2,1,2,5,40,3,3,0,3,3,7,0,0,Matches
752,Romain Faivre,fr FRA,MF,Bournemouth,eng Premier League,25-204,1998,0,0,0,0,0,0,0,1,0,1,0,0,0,0,0,0,0,Matches
753,Romain Faivre,fr FRA,"MF,FW",Lorient,fr Ligue 1,25-204,1998,16.1,13,6,5,4,4,6,15,40,9,6,1,5,7,20,3,1,Matches
754,Radamel Falcao,co COL,"FW,DF",Rayo Vallecano,es La Liga,37-358,1986,2.1,4,3,0,4,0,0,1,0,1,1,0,1,0,4,3,0,Matches
755,Wladimiro Falcone,it ITA,GK,Lecce,it Serie A,28-297,1995,23,0,0,0,0,0,0,0,,0,1,0,1,0,0,11,2,Matches
756,Fali,es ESP,DF,Cádiz,es La Liga,30-175,1993,19.6,27,16,18,8,1,12,22,54.5,10,29,20,9,20,47,83,0,Matches
757,Davide Faraoni,it ITA,DF,Hellas Verona,it Serie A,32-101,1991,6.7,13,10,5,6,2,7,10,70,3,9,5,4,6,19,21,0,Matches
758,Davide Faraoni,it ITA,DF,Fiorentina,it Serie A,32-101,1991,2.5,8,5,5,1,2,5,8,62.5,3,2,1,1,3,11,9,0,Matches
759,Ansu Fati,es ESP,"MF,FW",Brighton,eng Premier League,21-095,2002,3.2,2,1,1,1,0,0,6,0,6,3,0,3,1,3,2,0,Matches
760,Ansu Fati,es ESP,"MF,FW",Barcelona,es La Liga,21-095,2002,0.6,0,0,0,0,0,0,1,0,1,0,0,0,0,0,0,0,Matches
761,Khalil Fayad,fr FRA,"FW,MF",Montpellier,fr Ligue 1,19-239,2004,8.3,20,12,14,4,2,6,17,35.3,11,10,0,10,10,30,3,0,Matches
762,Federico Fazio,ar ARG,DF,Salernitana,it Serie A,36-323,1987,9.3,11,8,9,2,0,4,9,44.4,5,16,13,3,8,19,63,0,Matches
763,Jacopo Fazzini,it ITA,MF,Empoli,it Serie A,20-324,2003,9.1,35,19,20,9,6,22,42,52.4,20,16,1,15,7,42,12,0,Matches
764,Nabil Fekir,fr FRA,"FW,MF",Betis,es La Liga,30-200,1993,1.7,0,0,0,0,0,0,1,0,1,0,0,0,0,0,0,0,Matches
765,Felipe,br BRA,DF,Nott'ham Forest,eng Premier League,34-263,1989,1.5,5,4,3,2,0,4,5,80,1,2,1,1,1,6,5,0,Matches
766,Luiz Felipe,it ITA,DF,Betis,es La Liga,26-318,1997,4,7,3,5,2,0,4,5,80,1,10,4,6,4,11,16,0,Matches
767,João Félix,pt POR,FW,Barcelona,es La Liga,24-085,1999,11.9,16,11,9,3,4,4,13,30.8,9,11,1,10,8,24,5,0,Matches
768,Ohis Felix Uduokhai,de GER,DF,Augsburg,de Bundesliga,26-147,1997,17.5,18,9,10,5,3,8,13,61.5,5,14,11,3,24,42,98,1,Matches
769,Kiko Femenía,es ESP,"DF,MF",Villarreal,es La Liga,33-001,1991,4.6,6,4,3,2,1,2,4,50,2,7,3,4,9,15,10,0,Matches
770,Evan Ferguson,ie IRL,FW,Brighton,eng Premier League,19-107,2004,11.5,12,6,3,6,3,4,11,36.4,7,9,3,6,2,14,5,0,Matches
771,Lewis Ferguson,sct SCO,MF,Bologna,it Serie A,24-163,1999,19.9,27,15,12,12,3,12,27,44.4,15,12,5,7,12,39,20,0,Matches
772,Bruno Fernandes,pt POR,"MF,FW",Manchester Utd,eng Premier League,29-148,1994,21,45,29,18,16,11,22,58,37.9,36,24,1,23,14,59,26,1,Matches
773,Edimilson Fernandes,ch SUI,DF,Mainz 05,de Bundesliga,27-294,1996,10.7,17,11,12,5,0,11,17,64.7,6,8,2,6,21,38,42,0,Matches
774,Aitor Fernández,es ESP,GK,Osasuna,es La Liga,32-276,1991,4.1,0,0,0,0,0,0,1,0,1,0,0,0,0,0,2,1,Matches
775,Álex Fernández,es ESP,"MF,FW",Cádiz,es La Liga,31-111,1992,8.5,8,3,7,1,0,6,10,60,4,11,4,7,9,17,21,0,Matches
776,Carlos Fernández,es ESP,FW,Real Sociedad,es La Liga,27-257,1996,4.5,11,7,3,6,2,0,2,0,2,4,0,4,0,11,5,0,Matches
777,Enzo Fernández,ar ARG,MF,Chelsea,eng Premier League,23-017,2001,16,29,15,10,12,7,14,42,33.3,28,27,8,19,12,41,18,0,Matches
778,Raúl Fernández,es ESP,GK,Granada,es La Liga,35-327,1988,3.1,0,0,0,0,0,0,1,0,1,0,0,0,0,0,1,2,Matches
779,Valery Fernández,es ESP,"MF,DF",Girona,es La Liga,24-072,1999,4.5,8,6,4,4,0,4,6,66.7,2,6,1,5,0,8,3,0,Matches
780,Fernando,es ESP,GK,Almería,es La Liga,33-238,1990,2,0,0,0,0,0,0,0,,0,1,0,1,0,0,1,0,Matches
781,Fernando,br BRA,MF,Sevilla,es La Liga,36-193,1987,5.1,9,8,2,4,3,5,9,55.6,4,2,0,2,7,16,9,0,Matches
782,Ichem Ferrah,fr FRA,FW,Lille,fr Ligue 1,18-133,2005,0,0,0,0,0,0,0,0,,0,0,0,0,0,0,0,0,Matches
783,André Ferreira,pt POR,GK,Granada,es La Liga,27-250,1996,14.9,0,0,0,0,0,0,1,0,1,0,0,0,0,0,9,2,Matches
784,João Ferreira,pt POR,DF,Udinese,it Serie A,22-318,2001,13.5,36,28,24,10,2,20,32,62.5,12,19,5,14,17,53,55,0,Matches
785,Jordan Ferri,fr FRA,MF,Montpellier,fr Ligue 1,31-328,1992,13,17,8,9,8,0,11,41,26.8,30,13,1,12,12,29,12,0,Matches
786,Nacho Ferri,es ESP,"FW,MF",Eint Frankfurt,de Bundesliga,19-121,2004,0.6,3,3,1,2,0,2,2,100,0,0,0,0,0,3,2,0,Matches
787,Rachad Fettal,ma MAR,FW,Almería,es La Liga,19-018,2005,0.2,,0,,,,,,,,,,,0,,,,Matches
788,Seydou Fini,it ITA,"DF,FW",Genoa,it Serie A,17-246,2006,0.4,0,0,0,0,0,0,0,,0,0,0,0,0,0,0,0,Matches
789,Max Finkgräfe,de GER,"DF,MF",Köln,de Bundesliga,19-313,2004,6.1,19,13,14,5,0,12,27,44.4,15,12,3,9,10,29,11,0,Matches
790,Kilian Fischer,de GER,DF,Wolfsburg,de Bundesliga,23-114,2000,0.1,0,0,0,0,0,0,0,,0,0,0,0,0,0,0,0,Matches
791,John Fleck,sct SCO,"MF,DF",Sheffield Utd,eng Premier League,32-163,1991,1,1,0,0,1,0,0,1,0,1,0,0,0,0,1,1,0,Matches
792,Mark Flekken,nl NED,GK,Brentford,eng Premier League,30-235,1993,19.5,0,0,0,0,0,0,2,0,2,0,0,0,0,0,6,0,Matches
793,Alessandro Florenzi,it ITA,DF,Milan,it Serie A,32-329,1991,10.4,27,12,17,7,3,17,35,48.6,18,11,6,5,12,39,15,1,Matches
794,Phil Foden,eng ENG,"FW,MF",Manchester City,eng Premier League,23-251,2000,18.7,17,11,9,5,3,9,20,45,11,15,0,15,10,27,8,1,Matches
795,Wes Foderingham,eng ENG,GK,Sheffield Utd,eng Premier League,33-020,1991,21.4,3,1,3,0,0,3,4,75,1,0,0,0,0,3,10,6,Matches
796,Malick Fofana,be BEL,"DF,FW",Lyon,fr Ligue 1,18-309,2005,0.7,0,0,0,0,0,0,0,,0,1,0,1,1,1,0,0,Matches
797,Youssouf Fofana,fr FRA,MF,Monaco,fr Ligue 1,25-024,1999,16.5,30,17,7,18,5,16,32,50,16,20,4,16,20,50,14,1,Matches
798,Jonas Föhrenbach,de GER,DF,Heidenheim,de Bundesliga,28-008,1996,18.1,27,18,16,7,4,13,27,48.1,14,20,12,8,15,42,39,0,Matches
799,Thomas Foket,be BEL,DF,Reims,fr Ligue 1,29-131,1994,14.3,24,11,16,6,2,15,33,45.5,18,27,8,19,18,42,21,0,Matches
800,Michael Folorunsho,ng NGA,"MF,FW",Hellas Verona,it Serie A,25-361,1998,19.7,39,24,16,16,7,16,44,36.4,28,35,9,26,16,55,27,2,Matches
801,Pablo Fornals,es ESP,"MF,FW",West Ham,eng Premier League,27-346,1996,4.7,10,6,4,3,3,5,16,31.3,11,8,1,7,6,16,7,0,Matches
802,Emil Forsberg,se SWE,"MF,FW",RB Leipzig,de Bundesliga,32-103,1991,5.2,7,3,2,5,0,5,12,41.7,7,7,0,7,0,7,5,0,Matches
803,Omari Forson,eng ENG,FW,Manchester Utd,eng Premier League,19-198,2004,0.1,0,0,0,0,0,0,0,,0,0,0,0,0,0,0,0,Matches
804,Philipp Förster,de GER,"MF,FW",Bochum,de Bundesliga,28-364,1995,3.2,7,5,3,2,2,2,4,50,2,2,0,2,6,13,1,0,Matches
805,Héctor Fort,es ESP,DF,Barcelona,es La Liga,17-185,2006,0.5,1,0,1,0,0,1,3,33.3,2,0,0,0,1,2,0,0,Matches
806,Lyle Foster,za RSA,FW,Burnley,eng Premier League,23-153,2000,11.5,13,5,3,4,6,3,11,27.3,8,11,3,8,2,15,15,0,Matches
807,Dimitri Foulquier,fr FRA,"DF,MF",Valencia,es La Liga,30-317,1993,9.3,16,9,9,6,1,8,12,66.7,4,5,0,5,6,22,23,1,Matches
808,Juan Foyth,ar ARG,DF,Villarreal,es La Liga,26-022,1998,11.8,26,15,18,8,0,12,27,44.4,15,17,4,13,12,38,44,0,Matches
809,Matheus França,br BRA,"FW,MF",Crystal Palace,eng Premier League,19-308,2004,0.7,0,0,0,0,0,0,0,,0,1,0,1,0,0,0,0,Matches
810,Bartol Franjić,hr CRO,MF,Darmstadt 98,de Bundesliga,24-020,2000,8.6,6,6,1,4,1,2,13,15.4,11,8,1,7,24,30,19,1,Matches
811,Przemysław Frankowski,pl POL,DF,Lens,fr Ligue 1,28-297,1995,11.8,29,19,12,12,5,13,37,35.1,24,14,2,12,8,37,20,0,Matches
812,Nathan Fraser,ie IRL,FW,Wolves,eng Premier League,18-346,2005,0.1,0,0,0,0,0,0,1,0,1,1,1,0,0,0,1,0,Matches
813,Davide Frattesi,it ITA,MF,Inter,it Serie A,24-104,1999,5.2,3,0,1,2,0,1,3,33.3,2,3,0,3,1,4,8,0,Matches
814,Jean Frederic N'Guessan,ci CIV,"MF,FW",Metz,fr Ligue 1,20-292,2003,1.2,3,1,0,3,0,0,3,0,3,3,0,3,1,4,0,0,Matches
815,Morten Frendrup,dk DEN,MF,Genoa,it Serie A,22-302,2001,20.2,79,40,25,43,11,37,55,67.3,18,32,7,25,27,106,23,1,Matches
816,Remo Freuler,ch SUI,MF,Bologna,it Serie A,31-294,1992,15,39,23,21,15,3,18,32,56.3,14,21,6,15,20,59,23,1,Matches
817,Marco Friedl,at AUT,DF,Werder Bremen,de Bundesliga,25-324,1998,14.4,30,20,21,9,0,23,32,71.9,9,30,18,12,20,50,79,0,Matches
818,Marvin Friedrich,de GER,DF,M'Gladbach,de Bundesliga,28-052,1995,8.4,15,9,12,2,1,7,9,77.8,2,20,16,4,4,19,50,0,Matches
819,Jeremie Frimpong,nl NED,DF,Leverkusen,de Bundesliga,23-055,2000,16.9,16,10,8,5,3,5,14,35.7,9,23,0,23,5,21,9,0,Matches
820,Jorge de Frutos,es ESP,"MF,FW",Rayo Vallecano,es La Liga,26-348,1997,7.2,2,0,1,1,0,1,8,12.5,7,6,0,6,3,5,5,0,Matches
821,Chris Führich,de GER,"FW,MF",Stuttgart,de Bundesliga,26-025,1998,16.9,18,14,3,9,6,10,27,37,17,18,0,18,6,24,3,0,Matches
822,Shiō Fukuda,jp JPN,FW,M'Gladbach,de Bundesliga,19-301,2004,0.1,1,0,1,0,0,0,0,,0,0,0,0,0,1,0,0,Matches
823,Angelo Fulgini,fr FRA,MF,Lens,fr Ligue 1,27-167,1996,9.4,13,6,3,7,3,5,11,45.5,6,13,0,13,3,16,6,0,Matches
824,Niclas Füllkrug,de GER,FW,Werder Bremen,de Bundesliga,30-359,1993,2,1,1,0,1,0,1,1,100,0,2,1,1,0,1,1,0,Matches
825,Niclas Füllkrug,de GER,FW,Dortmund,de Bundesliga,30-359,1993,14.9,4,2,0,4,0,1,4,25,3,10,3,7,1,5,18,0,Matches
826,Matteo Gabbia,it ITA,DF,Milan,it Serie A,24-105,1999,3.1,8,7,6,2,0,6,6,100,0,2,1,1,1,9,16,0,Matches
827,Matteo Gabbia,it ITA,DF,Villarreal,es La Liga,24-105,1999,5.3,10,6,4,6,0,5,8,62.5,3,5,2,3,8,18,36,1,Matches
828,Gianluca Gaetano,it ITA,MF,Napoli,it Serie A,23-274,2000,1.8,4,1,0,4,0,2,4,50,2,5,2,3,1,5,4,0,Matches
829,Roberto Gagliardini,it ITA,"MF,DF",Monza,it Serie A,29-302,1994,18.9,45,23,19,20,6,23,33,69.7,10,23,5,18,26,71,29,0,Matches
830,Cody Gakpo,nl NED,"FW,MF",Liverpool,eng Premier League,24-272,1999,9.6,13,7,5,6,2,4,12,33.3,8,13,2,11,7,20,6,0,Matches
831,Javi Galán,es ESP,DF,Atlético Madrid,es La Liga,29-076,1994,1,5,4,2,2,1,4,5,80,1,1,0,1,1,6,3,0,Matches
832,Javi Galán,es ESP,DF,Real Sociedad,es La Liga,29-076,1994,1,4,3,1,3,0,2,3,66.7,1,4,0,4,1,5,0,0,Matches
833,Iñigo Ruiz de Galarreta,es ESP,MF,Athletic Club,es La Liga,30-181,1993,14.5,29,19,7,20,2,14,32,43.8,18,9,1,8,8,37,11,0,Matches
834,Pablo Galdames Millán,cl CHI,"MF,DF",Genoa,it Serie A,27-035,1996,0.1,0,0,0,0,0,0,0,,0,1,0,1,0,0,0,0,Matches
835,Conor Gallagher,eng ENG,MF,Chelsea,eng Premier League,23-362,2000,19.2,55,33,22,24,9,22,44,50,22,31,7,24,27,82,13,0,Matches
836,Antonino Gallo,it ITA,DF,Lecce,it Serie A,24-029,2000,14.9,27,19,19,7,1,23,33,69.7,10,18,5,13,11,38,44,0,Matches
837,Cristian Gamboa,cr CRC,DF,Bochum,de Bundesliga,34-102,1989,11.6,18,12,8,9,1,10,27,37,17,15,4,11,13,31,28,1,Matches
838,Kévin Gameiro,fr FRA,"FW,MF",Strasbourg,fr Ligue 1,36-270,1987,8.8,8,8,5,2,1,1,12,8.3,11,6,0,6,2,10,2,0,Matches
839,Idrissa Gana Gueye,sn SEN,MF,Everton,eng Premier League,34-130,1989,11.2,32,20,10,16,6,13,25,52,12,13,3,10,11,43,10,0,Matches
840,Ignatius Ganago,cm CMR,"FW,MF",Nantes,fr Ligue 1,24-352,1999,2,0,0,0,0,0,0,1,0,1,1,0,1,1,1,1,0,Matches
841,Aleix García,es ESP,MF,Girona,es La Liga,26-220,1997,20.9,25,16,10,11,4,14,30,46.7,16,30,12,18,26,51,34,0,Matches
842,Álvaro García,es ESP,"MF,FW",Rayo Vallecano,es La Liga,31-099,1992,17,21,16,9,7,5,3,21,14.3,18,19,0,19,23,44,20,0,Matches
843,Dani García,es ESP,MF,Athletic Club,es La Liga,33-255,1990,4.5,6,2,1,2,3,4,14,28.6,10,7,1,6,3,9,5,0,Matches
844,David García,es ESP,DF,Osasuna,es La Liga,29-354,1994,21,22,15,16,5,1,13,23,56.5,10,32,16,16,14,36,99,2,Matches
845,Eric García,es ESP,DF,Barcelona,es La Liga,23-025,2001,0.6,0,0,0,0,0,0,0,,0,1,1,0,0,0,0,0,Matches
846,Eric García,es ESP,DF,Girona,es La Liga,23-025,2001,13.6,23,17,11,9,3,14,22,63.6,8,13,8,5,16,39,39,1,Matches
847,Fran Garcia,es ESP,DF,Real Madrid,es La Liga,24-173,1999,10,12,9,4,6,2,6,16,37.5,10,8,1,7,14,26,14,1,Matches
848,Francisco Jesús Crespo García,es ESP,FW,Las Palmas,es La Liga,27-189,1996,4.9,12,8,3,6,3,6,18,33.3,12,4,0,4,2,14,5,0,Matches
849,Gonzalo García,es ESP,"FW,MF",Real Madrid,es La Liga,19-316,2004,0.2,0,0,0,0,0,0,1,0,1,1,1,0,0,0,1,0,Matches
850,Raúl García,es ESP,"FW,MF",Athletic Club,es La Liga,37-207,1986,1.5,1,1,1,0,0,1,4,25,3,2,0,2,1,2,3,0,Matches
851,Rubén García,es ESP,"FW,MF",Osasuna,es La Liga,30-204,1993,7.4,10,7,1,7,2,4,11,36.4,7,13,2,11,4,14,8,0,Matches
852,Santiago García,,FW,Getafe,es La Liga,22-158,2001,0.3,1,0,0,0,1,1,1,100,0,0,0,0,0,1,0,0,Matches
853,Ulisses Garcia,ch SUI,DF,Marseille,fr Ligue 1,28-023,1996,1,4,4,0,4,0,2,2,100,0,1,0,1,1,5,1,0,Matches
854,Unai García,es ESP,DF,Osasuna,es La Liga,32-000,1992,1.7,4,4,3,0,1,0,0,,0,2,1,1,4,8,7,0,Matches
855,Alejandro Garnacho,ar ARG,FW,Manchester Utd,eng Premier League,19-217,2004,13.8,13,9,5,4,4,7,23,30.4,16,15,1,14,9,22,12,0,Matches
856,James Garner,eng ENG,MF,Everton,eng Premier League,22-327,2001,19.9,56,30,24,23,9,24,57,42.1,33,28,10,18,30,86,30,0,Matches
857,Luca Garritano,it ITA,"MF,DF",Frosinone,it Serie A,29-357,1994,5.3,9,4,7,2,0,5,15,33.3,10,13,0,13,4,13,8,1,Matches
858,Johan Gastien,fr FRA,MF,Clermont Foot,fr Ligue 1,36-009,1988,12.6,19,8,8,9,2,14,39,35.9,25,13,5,8,14,33,16,2,Matches
859,Federico Gatti,it ITA,DF,Juventus,it Serie A,25-224,1998,17.3,19,11,11,7,1,11,15,73.3,4,13,9,4,11,30,60,0,Matches
860,Federico Gattoni,ar ARG,"DF,FW",Sevilla,es La Liga,24-352,1999,0.1,1,0,1,0,0,1,1,100,0,0,0,0,0,1,1,0,Matches
861,Gavi,es ESP,"MF,FW",Barcelona,es La Liga,19-182,2004,10.5,39,21,20,14,5,18,36,50,18,19,3,16,8,47,16,1,Matches
862,Paulo Gazzaniga,ar ARG,GK,Girona,es La Liga,32-032,1992,22,2,2,2,0,0,2,2,100,0,0,0,0,0,2,5,0,Matches
863,Yann Gboho,fr FRA,FW,Toulouse,fr Ligue 1,23-020,2001,0.5,1,1,0,1,0,1,1,100,0,0,0,0,0,1,0,0,Matches
864,Gelabert,es ESP,"FW,MF",Toulouse,fr Ligue 1,23-095,2000,7.7,12,7,5,5,2,7,20,35,13,7,2,5,4,16,8,0,Matches
865,Francesco Gelli,it ITA,"MF,DF",Frosinone,it Serie A,27-111,1996,11.7,14,9,7,2,5,8,13,61.5,5,12,2,10,9,23,16,1,Matches
866,Luca Gemello,it ITA,GK,Torino,it Serie A,23-215,2000,1,0,0,0,0,0,0,1,0,1,0,0,0,0,0,1,0,Matches
867,Valentin Gendrey,fr FRA,DF,Lecce,it Serie A,23-227,2000,21.5,35,19,22,10,3,21,31,67.7,10,21,4,17,25,60,59,0,Matches
868,Denis Genreau,au AUS,"FW,MF",Toulouse,fr Ligue 1,24-258,1999,4.8,11,8,5,6,0,8,13,61.5,5,8,1,7,4,15,8,0,Matches
869,Yannick Gerhardt,de GER,"MF,FW",Wolfsburg,de Bundesliga,29-327,1994,8.7,7,3,4,2,1,2,15,13.3,13,10,2,8,5,12,13,0,Matches
870,Anwar El Ghazi,nl NED,"MF,DF",Mainz 05,de Bundesliga,28-276,1995,0.6,0,0,0,0,0,0,1,0,1,0,0,0,0,0,0,0,Matches
871,Farés Ghedjemis,fr FRA,"MF,FW",Frosinone,it Serie A,21-150,2002,1.1,1,0,0,0,1,0,1,0,1,0,0,0,0,1,2,0,Matches
872,Saman Ghoddos,ir IRN,DF,Brentford,eng Premier League,30-150,1993,7.8,25,17,19,4,2,16,27,59.3,11,8,2,6,5,30,11,0,Matches
873,Morgan Gibbs-White,eng ENG,"MF,FW",Nott'ham Forest,eng Premier League,24-007,2000,19.7,26,18,4,13,9,12,24,50,12,14,2,12,9,35,15,0,Matches
874,Samuel Gigot,fr FRA,DF,Marseille,fr Ligue 1,30-114,1993,12.7,25,18,10,13,2,10,16,62.5,6,19,12,7,18,43,75,0,Matches
875,Bryan Gil,es ESP,"FW,MF",Tottenham,eng Premier League,22-357,2001,2.1,1,0,0,0,1,1,3,33.3,2,2,0,2,3,4,3,0,Matches
876,David Gil,es ESP,GK,Cádiz,es La Liga,30-023,1994,3.1,0,0,0,0,0,0,0,,0,0,0,0,0,0,3,0,Matches
877,Mario Gila,es ESP,DF,Lazio,it Serie A,23-158,2000,9,12,4,9,2,1,8,12,66.7,4,9,6,3,7,19,29,0,Matches
878,Alfie Gilchrist,eng ENG,"DF,FW",Chelsea,eng Premier League,20-067,2003,0,1,0,1,0,0,0,0,,0,0,0,0,1,2,2,0,Matches
879,Billy Gilmour,sct SCO,MF,Brighton,eng Premier League,22-237,2001,15.9,16,10,10,4,2,7,25,28,18,18,7,11,6,22,10,0,Matches
880,Benedikt Gimber,de GER,DF,Heidenheim,de Bundesliga,26-349,1997,10.2,25,15,15,9,1,14,18,77.8,4,14,10,4,8,33,48,0,Matches
881,Gvidas Gineitis,lt LTU,MF,Torino,it Serie A,19-294,2004,2.4,4,3,0,4,0,2,3,66.7,1,5,2,3,3,7,6,1,Matches
882,Matthias Ginter,de GER,DF,Freiburg,de Bundesliga,30-015,1994,17.3,22,11,14,8,0,12,23,52.2,11,29,19,10,14,36,72,0,Matches
883,Olivier Giroud,fr FRA,FW,Milan,it Serie A,37-126,1986,15.8,11,7,3,5,3,1,6,16.7,5,10,3,7,4,15,16,0,Matches
884,Klaus Gjasula,al ALB,"DF,MF",Darmstadt 98,de Bundesliga,34-051,1989,8,26,15,12,14,0,8,12,66.7,4,11,6,5,10,36,30,0,Matches
885,Serge Gnabry,de GER,"FW,MF",Bayern Munich,de Bundesliga,28-204,1995,2.5,3,2,0,3,0,2,9,22.2,7,3,0,3,0,3,2,0,Matches
886,Ben Godfrey,eng ENG,DF,Everton,eng Premier League,26-019,1998,2,5,3,3,2,0,4,7,57.1,3,1,0,1,2,7,10,0,Matches
887,Edoardo Goldaniga,it ITA,DF,Cagliari,it Serie A,30-093,1993,11.2,12,7,9,3,0,4,10,40,6,11,7,4,15,27,37,1,Matches
888,Pierluigi Gollini,it ITA,GK,Napoli,it Serie A,28-322,1995,5,1,1,1,0,0,1,1,100,0,0,0,0,1,2,1,0,Matches
889,Aleksandr Golovin,ru RUS,MF,Monaco,fr Ligue 1,27-249,1996,16.1,24,16,9,12,3,8,22,36.4,14,24,2,22,13,37,6,0,Matches
890,André Gomes,pt POR,MF,Everton,eng Premier League,30-188,1993,1.8,1,1,1,0,0,0,1,0,1,6,0,6,0,1,0,0,Matches
891,Angel Gomes,eng ENG,MF,Lille,fr Ligue 1,23-156,2000,16.2,16,8,3,8,5,9,17,52.9,8,13,2,11,13,29,18,1,Matches
892,João Gomes,br BRA,MF,Wolves,eng Premier League,22-356,2001,15.5,58,34,28,24,6,23,53,43.4,30,30,3,27,12,70,12,2,Matches
893,Toti Gomes,pt POR,DF,Wolves,eng Premier League,25-018,1999,16.2,28,19,19,6,3,15,19,78.9,4,17,11,6,13,41,40,1,Matches
894,Joe Gomez,eng ENG,DF,Liverpool,eng Premier League,26-256,1997,12.1,33,20,17,11,5,23,41,56.1,18,16,3,13,12,45,31,2,Matches
895,Maxi Gómez,uy URU,FW,Cádiz,es La Liga,27-173,1996,7.8,1,1,1,0,0,1,1,100,0,4,3,1,2,3,3,0,Matches
896,Moi Gómez,es ESP,"MF,FW",Osasuna,es La Liga,29-225,1994,13.5,25,16,6,15,4,8,18,44.4,10,9,1,8,9,34,8,0,Matches
897,Papu Gómez,ar ARG,"MF,FW",Monza,it Serie A,35-353,1988,0.5,0,0,0,0,0,0,2,0,2,0,0,0,1,1,0,0,Matches
898,Sergio Gómez,es ESP,FW,Manchester City,eng Premier League,23-152,2000,0.2,0,0,0,0,0,0,0,,0,0,0,0,1,1,0,0,Matches
899,Unai Gómez,es ESP,MF,Athletic Club,es La Liga,20-254,2003,2.9,3,2,0,2,1,1,2,50,1,4,0,4,1,4,6,0,Matches
900,Maxime Gonalons,fr FRA,MF,Clermont Foot,fr Ligue 1,34-330,1989,11.8,36,25,12,19,5,19,45,42.2,26,16,3,13,18,54,8,0,Matches
901,Édgar González,es ESP,DF,Almería,es La Liga,26-308,1997,16.1,26,12,11,13,2,14,26,53.8,12,30,17,13,20,46,75,1,Matches
902,Giovanni González,uy URU,DF,Mallorca,es La Liga,29-136,1994,15.9,45,30,22,22,1,23,46,50,23,14,2,12,15,60,37,1,Matches
903,Hugo González,es ESP,"MF,FW",Valencia,es La Liga,20-361,2003,0.6,2,1,0,2,0,0,0,,0,0,0,0,0,2,0,0,Matches
904,Iñaki González,es ESP,MF,Las Palmas,es La Liga,19-191,2004,0.1,1,0,1,0,0,0,0,,0,0,0,0,0,1,1,0,Matches
905,Joan Gonzàlez,es ESP,MF,Lecce,it Serie A,22-002,2002,9.9,18,9,8,7,3,9,15,60,6,12,1,11,3,21,5,0,Matches
906,Nicolás González,ar ARG,FW,Fiorentina,it Serie A,25-303,1998,10.8,15,10,8,5,2,4,15,26.7,11,14,1,13,5,20,4,0,Matches
907,Urko González,es ESP,"MF,DF",Real Sociedad,es La Liga,22-320,2001,1.5,3,0,0,2,1,1,1,100,0,1,0,1,0,3,4,0,Matches
908,Anthony Gordon,eng ENG,FW,Newcastle Utd,eng Premier League,22-344,2001,19.4,38,22,12,19,7,16,45,35.6,29,22,0,22,4,42,2,0,Matches
909,Kaide Gordon,eng ENG,FW,Liverpool,eng Premier League,19-121,2004,0,0,0,0,0,0,0,0,,0,0,0,0,0,0,0,0,Matches
910,Daniel Gore,eng ENG,MF,Manchester Utd,eng Premier League,19-130,2004,0,1,1,0,1,0,1,1,100,0,0,0,0,1,2,0,0,Matches
911,Leon Goretzka,de GER,MF,Bayern Munich,de Bundesliga,28-362,1995,11.7,15,9,7,4,4,6,20,30,14,16,0,16,14,29,19,0,Matches
912,Andoni Gorosabel,es ESP,DF,Alavés,es La Liga,27-183,1996,20.7,36,24,21,13,2,22,48,45.8,26,14,3,11,17,53,47,0,Matches
913,Robin Gosens,de GER,"DF,MF",Union Berlin,de Bundesliga,29-213,1994,12.5,33,21,9,21,3,18,23,78.3,5,28,3,25,21,54,36,0,Matches
914,Mario Götze,de GER,MF,Eint Frankfurt,de Bundesliga,31-245,1992,11.5,21,13,9,7,5,13,29,44.8,16,12,1,11,5,26,6,0,Matches
915,Amine Gouiri,dz ALG,"FW,MF",Rennes,fr Ligue 1,23-352,2000,13.2,14,9,4,6,4,6,12,50,6,9,0,9,7,21,6,0,Matches
916,Jeffrey Gouweleeuw,nl NED,DF,Augsburg,de Bundesliga,32-208,1991,15,19,13,7,10,2,8,11,72.7,3,25,11,14,22,41,63,0,Matches
917,Pablo Gozalbez,es ESP,"MF,FW",Valencia,es La Liga,22-279,2001,1.1,1,0,0,0,1,1,6,16.7,5,0,0,0,1,2,2,0,Matches
918,Jonathan Gradit,fr FRA,DF,Lens,fr Ligue 1,31-071,1992,14,22,12,11,9,2,12,22,54.5,10,14,6,8,22,44,31,0,Matches
919,Jens Grahl,de GER,GK,Eint Frankfurt,de Bundesliga,35-134,1988,1,0,0,0,0,0,0,0,,0,0,0,0,0,0,1,0,Matches
920,Samuel Grandsir,fr FRA,"FW,MF",Le Havre,fr Ligue 1,27-173,1996,4.4,11,8,2,7,2,4,13,30.8,9,2,0,2,3,14,3,1,Matches
921,Alberto Grassi,it ITA,MF,Empoli,it Serie A,28-333,1995,14.9,17,11,8,8,1,5,17,29.4,12,19,9,10,36,53,25,0,Matches
922,Ryan Gravenberch,nl NED,MF,Liverpool,eng Premier League,21-263,2002,7.3,12,5,2,6,4,3,14,21.4,11,9,1,8,10,22,6,0,Matches
923,Ryan Gravenberch,nl NED,FW,Bayern Munich,de Bundesliga,21-263,2002,0.1,0,0,0,0,0,0,0,,0,0,0,0,0,0,0,0,Matches
924,Adrian Grbić,at AUT,FW,Lorient,fr Ligue 1,27-183,1996,0.3,0,0,0,0,0,0,0,,0,0,0,0,0,0,0,0,Matches
925,Ivo Grbić,hr CRO,GK,Sheffield Utd,eng Premier League,28-016,1996,0.6,0,0,0,0,0,0,0,,0,0,0,0,0,0,0,0,Matches
926,Jack Grealish,eng ENG,FW,Manchester City,eng Premier League,28-146,1995,7.8,12,8,6,6,0,6,11,54.5,5,12,2,10,4,16,4,0,Matches
927,Mason Greenwood,eng ENG,"MF,FW",Getafe,es La Liga,22-125,2001,14.8,4,2,1,1,2,1,8,12.5,7,3,0,3,2,6,1,0,Matches
928,Michael Gregoritsch,at AUT,FW,Freiburg,de Bundesliga,29-291,1994,9.4,5,4,2,1,2,1,8,12.5,7,9,1,8,9,14,12,0,Matches
929,Antoine Griezmann,fr FRA,"FW,MF",Atlético Madrid,es La Liga,32-319,1991,19.6,24,13,7,12,5,10,30,33.3,20,24,2,22,7,31,16,0,Matches
930,Vincenzo Grifo,it ITA,"MF,FW",Freiburg,de Bundesliga,30-302,1993,14.8,17,13,5,8,4,7,18,38.9,11,13,0,13,6,23,8,0,Matches
931,Florian Grillitsch,at AUT,"MF,DF",Hoffenheim,de Bundesliga,28-180,1995,11.6,21,15,13,6,2,8,26,30.8,18,15,4,11,17,38,21,2,Matches
932,Álex Grimaldo,es ESP,DF,Leverkusen,de Bundesliga,28-136,1995,18.9,29,14,16,4,9,21,34,61.8,13,21,5,16,12,41,24,0,Matches
933,Christian Groß,de GER,"MF,DF",Werder Bremen,de Bundesliga,34-360,1989,5.1,10,6,6,4,0,4,15,26.7,11,7,2,5,5,15,10,1,Matches
934,Pascal Groß,de GER,"MF,DF",Brighton,eng Premier League,32-233,1991,19.2,37,20,18,10,9,17,40,42.5,23,24,4,20,14,51,18,2,Matches
935,Brajan Gruda,de GER,"MF,FW",Mainz 05,de Bundesliga,19-248,2004,9.2,7,5,2,3,2,6,12,50,6,12,0,12,3,10,3,0,Matches
936,Ilia Gruev,bg BUL,MF,Werder Bremen,de Bundesliga,23-273,2000,0,0,0,0,0,0,0,0,,0,0,0,0,0,0,0,0,Matches
937,Vicente Guaita,es ESP,GK,Celta Vigo,es La Liga,37-024,1987,12.7,1,1,1,0,0,1,1,100,0,0,0,0,0,1,5,0,Matches
938,Andrés Guardado,mx MEX,MF,Betis,es La Liga,37-128,1986,5,17,12,5,9,3,7,14,50,7,4,2,2,6,23,5,0,Matches
939,Sergi Guardiola,es ESP,"FW,MF",Cádiz,es La Liga,32-250,1991,3.2,4,3,1,1,2,3,5,60,2,4,0,4,0,4,3,0,Matches
940,Nemanja Gudelj,rs SRB,DF,Sevilla,es La Liga,32-079,1991,15.3,18,13,11,5,2,10,22,45.5,12,13,7,6,19,37,47,0,Matches
941,Gabriel Gudmundsson,se SWE,"DF,FW",Lille,fr Ligue 1,24-280,1999,7.6,11,8,3,8,0,8,11,72.7,3,6,2,4,6,17,13,0,Matches
942,Gonçalo Guedes,pt POR,MF,Villarreal,es La Liga,27-066,1996,0.6,0,0,0,0,0,0,1,0,1,0,0,0,0,0,0,0,Matches
943,Axel Gueguin,fr FRA,"DF,FW",Montpellier,fr Ligue 1,18-316,2005,1.3,9,5,6,2,1,2,6,33.3,4,2,0,2,2,11,6,0,Matches
944,Marc Guéhi,eng ENG,DF,Crystal Palace,eng Premier League,23-205,2000,20.9,25,16,21,4,0,12,21,57.1,9,22,17,5,17,42,86,1,Matches
945,Mattéo Guendouzi,fr FRA,MF,Lazio,it Serie A,24-295,1999,14.8,21,9,6,11,4,14,30,46.7,16,12,1,11,14,35,13,1,Matches
946,Mattéo Guendouzi,fr FRA,MF,Marseille,fr Ligue 1,24-295,1999,0.2,0,0,0,0,0,0,0,,0,1,1,0,0,0,0,0,Matches
947,Javier Guerra,es ESP,"MF,FW",Valencia,es La Liga,21-033,2003,15.9,27,14,14,9,4,9,28,32.1,19,17,2,15,9,36,24,0,Matches
948,Raphaël Guerreiro,pt POR,"MF,DF",Bayern Munich,de Bundesliga,30-043,1993,6.9,13,11,5,5,3,5,9,55.6,4,4,0,4,9,22,4,1,Matches
949,Axel Guessand,fr FRA,DF,Udinese,it Serie A,19-089,2004,0.5,1,1,0,1,0,1,1,100,0,1,0,1,0,1,0,0,Matches
950,Evann Guessand,fr FRA,FW,Nice,fr Ligue 1,22-217,2001,8.4,7,3,0,3,4,1,2,50,1,7,1,6,3,10,5,0,Matches
951,Ander Guevara,es ESP,MF,Alavés,es La Liga,26-211,1997,20.4,41,23,20,16,5,23,44,52.3,21,21,7,14,7,48,28,1,Matches
952,Pape Gueye,sn SEN,MF,Marseille,fr Ligue 1,25-010,1999,0.3,3,1,0,3,0,1,2,50,1,2,0,2,1,4,1,0,Matches
953,Josuha Guilavogui,fr FRA,DF,Mainz 05,de Bundesliga,33-137,1990,0.3,2,1,2,0,0,1,1,100,0,3,1,2,1,3,2,0,Matches
954,Morgan Guilavogui,gn GUI,"FW,MF",Lens,fr Ligue 1,25-330,1998,5.4,16,9,2,11,3,5,11,45.5,6,6,1,5,4,20,3,0,Matches
955,Frederic Guilbert,fr FRA,"DF,MF",Strasbourg,fr Ligue 1,29-041,1994,14.7,50,29,28,17,5,27,45,60,18,23,3,20,43,93,41,1,Matches
956,Hugo Guillamón,es ESP,MF,Valencia,es La Liga,24-003,2000,7.8,16,9,4,10,2,8,12,66.7,4,1,1,0,8,24,21,1,Matches
957,Bruno Guimarães,br BRA,MF,Newcastle Utd,eng Premier League,26-079,1997,20.6,48,30,28,14,6,18,42,42.9,24,29,7,22,19,67,14,0,Matches
958,Serhou Guirassy,gn GUI,FW,Stuttgart,de Bundesliga,27-328,1996,11.7,3,2,0,3,0,1,3,33.3,2,4,1,3,2,5,13,0,Matches
959,Marc Guiu,es ESP,MF,Barcelona,es La Liga,18-030,2006,0.1,1,0,0,1,0,0,0,,0,0,0,0,0,1,0,0,Matches
960,Manuel Gulde,de GER,DF,Freiburg,de Bundesliga,32-356,1991,9.9,16,12,10,5,1,6,7,85.7,1,12,7,5,12,28,30,0,Matches
961,Arda Güler,tr TUR,FW,Real Madrid,es La Liga,18-343,2005,0.1,2,2,1,1,0,2,2,100,0,0,0,0,0,2,0,0,Matches
962,Gerard Gumbau,es ESP,MF,Granada,es La Liga,29-047,1994,17.6,28,16,8,18,2,7,27,25.9,20,15,3,12,12,40,19,1,Matches
963,Robert Gumny,pl POL,DF,Augsburg,de Bundesliga,25-244,1998,5.2,6,5,1,3,2,1,5,20,4,13,5,8,7,13,13,0,Matches
964,İlkay Gündoğan,de GER,MF,Barcelona,es La Liga,33-102,1990,20.4,16,10,7,8,1,7,18,38.9,11,12,2,10,15,31,8,0,Matches
965,Christian Günter,de GER,DF,Freiburg,de Bundesliga,30-340,1993,1,1,0,1,0,0,0,0,,0,2,1,1,0,1,2,0,Matches
966,Jon Guridi,es ESP,"MF,FW",Alavés,es La Liga,28-340,1995,17.5,23,13,4,16,3,6,29,20.7,23,18,2,16,11,34,7,0,Matches
967,Gorka Guruzeta,es ESP,FW,Athletic Club,es La Liga,27-144,1996,17.2,24,16,4,19,1,6,20,30,14,19,1,18,14,38,17,0,Matches
968,Malo Gusto,fr FRA,DF,Chelsea,eng Premier League,20-260,2003,10.4,26,13,21,5,0,15,25,60,10,13,2,11,7,33,20,1,Matches
969,Miguel Gutiérrez,es ESP,"DF,MF",Girona,es La Liga,22-191,2001,20.7,20,13,8,8,4,10,25,40,15,16,7,9,13,33,49,0,Matches
970,Albert Guðmundsson,is ISL,"FW,MF",Genoa,it Serie A,26-233,1997,19.9,12,5,6,3,3,7,22,31.8,15,8,1,7,10,22,5,0,Matches
971,Joško Gvardiol,hr CRO,DF,Manchester City,eng Premier League,22-011,2002,15.4,27,18,9,14,4,12,21,57.1,9,18,8,10,19,46,23,2,Matches
972,Emmanuel Gyasi,gh GHA,"FW,MF",Empoli,it Serie A,30-023,1994,8,16,7,6,8,2,7,11,63.6,4,9,4,5,2,18,11,1,Matches
973,Norbert Gyömbér,sk SVK,DF,Salernitana,it Serie A,31-215,1992,17,35,17,29,6,0,19,24,79.2,5,32,22,10,22,57,69,2,Matches
974,Erling Haaland,no NOR,FW,Manchester City,eng Premier League,23-197,2000,14.6,3,1,0,3,0,2,2,100,0,9,1,8,1,4,9,0,Matches
975,Nicolas Haas,ch SUI,MF,Empoli,it Serie A,28-011,1996,1,5,3,1,2,2,3,3,100,0,1,0,1,1,6,1,0,Matches
976,Janik Haberer,de GER,MF,Union Berlin,de Bundesliga,29-307,1994,10.5,30,21,13,12,5,18,36,50,18,17,2,15,8,38,9,0,Matches
977,Robin Hack,de GER,"FW,MF",M'Gladbach,de Bundesliga,25-160,1998,6.1,5,2,1,4,0,0,7,0,7,8,0,8,7,12,10,0,Matches
978,Antwoine Hackford,eng ENG,FW,Sheffield Utd,eng Premier League,19-320,2004,0.1,0,0,0,0,0,0,0,,0,0,0,0,0,0,0,0,Matches
979,Munir El Haddadi,ma MAR,FW,Las Palmas,es La Liga,28-155,1995,18.3,30,19,14,12,4,14,33,42.4,19,16,1,15,8,38,10,0,Matches
980,Jaouen Hadjam,dz ALG,DF,Nantes,fr Ligue 1,20-314,2003,1.2,6,4,5,1,0,1,2,50,1,0,0,0,3,9,2,0,Matches
981,Ianis Hagi,ro ROU,"MF,FW",Alavés,es La Liga,25-104,1998,6.2,10,8,2,7,1,3,10,30,7,6,0,6,1,11,4,0,Matches
982,Amadou Haidara,ml MLI,MF,RB Leipzig,de Bundesliga,26-003,1998,7.1,17,12,9,6,2,7,15,46.7,8,12,1,11,10,27,8,0,Matches
983,Massadio Haïdara,ml MLI,DF,Lens,fr Ligue 1,31-063,1992,6.2,7,6,3,3,1,2,4,50,2,6,1,5,10,17,18,1,Matches
984,Oualid El Hajjam,ma MAR,"DF,MF",Le Havre,fr Ligue 1,32-349,1991,1.2,3,3,2,1,0,0,2,0,2,3,1,2,2,5,4,0,Matches
985,Achraf Hakimi,ma MAR,DF,Paris S-G,fr Ligue 1,25-091,1998,13,18,11,7,7,4,11,23,47.8,12,20,2,18,10,28,15,1,Matches
986,Lewis Hall,eng ENG,DF,Newcastle Utd,eng Premier League,19-148,2004,1.2,10,7,7,3,0,4,7,57.1,3,2,0,2,2,12,0,0,Matches
987,Sébastien Haller,ci CIV,FW,Dortmund,de Bundesliga,29-226,1994,4,1,0,0,1,0,1,1,100,0,4,1,3,0,1,7,0,Matches
988,Gustavo Hamer,nl NED,MF,Sheffield Utd,eng Premier League,26-224,1997,17.9,31,17,16,10,5,11,44,25,33,21,3,18,15,46,23,0,Matches
989,Andreas Hanche-Olsen,no NOR,DF,Mainz 05,de Bundesliga,27-017,1997,0.7,3,0,2,1,0,1,1,100,0,0,0,0,0,3,2,0,Matches
990,Ridgeciano Haps,sr SUR,"DF,FW",Genoa,it Serie A,30-236,1993,6.4,4,4,2,0,2,3,4,75,1,3,0,3,5,9,5,1,Matches
991,Genki Haraguchi,jp JPN,MF,Stuttgart,de Bundesliga,32-270,1991,0.2,1,1,1,0,0,0,0,,0,0,0,0,0,1,1,0,Matches
992,Amine Harit,ma MAR,"MF,FW",Marseille,fr Ligue 1,26-230,1997,10.6,18,10,3,13,2,9,22,40.9,13,16,3,13,6,24,1,0,Matches
993,Luke Harris,wls WAL,MF,Fulham,eng Premier League,18-306,2005,0.8,1,1,1,0,0,0,1,0,1,0,0,0,0,1,0,0,Matches
994,Jack Harrison,eng ENG,"MF,FW",Everton,eng Premier League,27-075,1996,14.4,17,8,3,6,8,10,26,38.5,16,11,0,11,6,23,14,0,Matches
995,Abdou Harroui,nl NED,MF,Frosinone,it Serie A,26-021,1998,6.7,13,7,5,8,0,5,9,55.6,4,8,0,8,2,15,2,0,Matches
996,Makoto Hasebe,jp JPN,"DF,MF",Eint Frankfurt,de Bundesliga,40-016,1984,0.4,2,2,2,0,0,2,2,100,0,0,0,0,0,2,1,0,Matches
997,Hans Hateboer,nl NED,DF,Atalanta,it Serie A,30-025,1994,5,6,3,4,1,1,2,4,50,2,8,0,8,2,8,8,0,Matches
998,Pantelis Hatzidiakos,gr GRE,DF,Cagliari,it Serie A,27-016,1997,7.1,18,7,10,8,0,9,15,60,6,11,4,7,6,24,19,1,Matches
999,Kai Havertz,de GER,MF,Arsenal,eng Premier League,24-237,1999,14,23,10,3,15,5,11,24,45.8,13,17,1,16,11,34,7,0,Matches
1000,Thorgan Hazard,be BEL,DF,Dortmund,de Bundesliga,30-311,1993,0.1,0,0,0,0,0,0,0,,0,0,0,0,0,0,0,0,Matches
1001,Jan Paul van Hecke,nl NED,DF,Brighton,eng Premier League,23-240,2000,15.3,27,13,16,9,2,15,26,57.7,11,31,17,14,17,44,55,3,Matches
1002,Hwang Hee-chan,kr KOR,"FW,MF",Wolves,eng Premier League,28-008,1996,16.1,14,6,9,4,1,7,20,35,13,17,1,16,8,22,8,0,Matches
1003,Silvan Hefti,ch SUI,"MF,DF",Genoa,it Serie A,26-101,1997,1.3,6,1,2,3,1,4,7,57.1,3,2,0,2,0,6,1,0,Matches
1004,Silvan Hefti,ch SUI,DF,Montpellier,fr Ligue 1,26-101,1997,2,8,5,4,4,0,6,14,42.9,8,2,1,1,2,10,3,0,Matches
1005,Dominique Heintz,de GER,DF,Köln,de Bundesliga,30-172,1993,4.6,11,5,6,5,0,7,10,70,3,6,1,5,3,14,20,0,Matches
1006,Dean Henderson,eng ENG,GK,Crystal Palace,eng Premier League,26-328,1997,6,0,0,0,0,0,0,0,,0,0,0,0,0,0,6,1,Matches
1007,Liam Henderson,sct SCO,MF,Empoli,it Serie A,27-284,1996,0.1,0,0,0,0,0,0,0,,0,0,0,0,0,0,0,0,Matches
1008,Benjamin Henrichs,de GER,DF,RB Leipzig,de Bundesliga,26-345,1997,15.3,35,20,13,17,5,13,30,43.3,17,24,1,23,14,49,12,0,Matches
1009,Henrique,br BRA,DF,Lyon,fr Ligue 1,29-284,1994,3.7,5,3,2,3,0,2,4,50,2,3,1,2,8,13,1,0,Matches
1010,Luis Henrique,br BRA,FW,Marseille,fr Ligue 1,22-051,2001,1,0,0,0,0,0,0,0,,0,2,0,2,1,1,0,0,Matches
1011,Luiz Henrique,br BRA,FW,Betis,es La Liga,23-032,2001,6.8,15,11,4,10,1,9,14,64.3,5,11,0,11,5,20,8,0,Matches
1012,Matheus Henrique,br BRA,MF,Sassuolo,it Serie A,26-046,1997,15.9,20,13,9,10,1,10,26,38.5,16,8,4,4,11,31,19,3,Matches
1013,Rico Henry,eng ENG,DF,Brentford,eng Premier League,26-210,1997,4.5,7,5,3,3,1,6,7,85.7,1,8,3,5,5,12,5,1,Matches
1014,Thomas Henry,fr FRA,"FW,MF",Hellas Verona,it Serie A,29-136,1994,2.5,0,0,0,0,0,0,0,,0,0,0,0,0,0,4,0,Matches
1015,Christophe Hérelle,mq MTQ,DF,Metz,fr Ligue 1,31-165,1992,10,15,7,11,4,0,6,11,54.5,5,9,4,5,7,22,33,0,Matches
1016,Mario Hermoso,es ESP,DF,Atlético Madrid,es La Liga,28-230,1995,18.6,29,17,15,12,2,15,28,53.6,13,19,8,11,20,49,70,0,Matches
1017,Javi Hernández,es ESP,DF,Cádiz,es La Liga,25-277,1998,16.5,16,11,10,3,3,10,21,47.6,11,20,7,13,9,25,47,0,Matches
1018,Aridane Hernández,es ESP,DF,Rayo Vallecano,es La Liga,34-317,1989,12.8,9,7,4,4,1,4,9,44.4,5,12,8,4,10,19,66,1,Matches
1019,Lucas Hernández,fr FRA,DF,Paris S-G,fr Ligue 1,27-354,1996,14.8,40,27,22,12,6,23,42,54.8,19,15,3,12,21,61,28,0,Matches
1020,Luis Hernández,es ESP,DF,Cádiz,es La Liga,34-295,1989,8,7,3,4,3,0,4,8,50,4,3,2,1,8,15,25,0,Matches
1021,Theo Hernández,fr FRA,DF,Milan,it Serie A,26-120,1997,18.9,21,11,14,7,0,7,15,46.7,8,26,13,13,13,34,29,1,Matches
1022,Yarek Hernandis,es ESP,DF,Valencia,es La Liga,19-022,2005,3.2,,7,,,,,,,,,,,7,,,,Matches
1023,Jorge Herrando,es ESP,DF,Osasuna,es La Liga,22-340,2001,3.4,5,4,4,1,0,1,2,50,1,3,1,2,3,8,17,0,Matches
1024,Ander Herrera,es ESP,MF,Athletic Club,es La Liga,34-173,1989,8.5,35,25,8,23,4,16,29,55.2,13,9,1,8,14,49,12,0,Matches
1025,Cristian Herrera,es ESP,FW,Las Palmas,es La Liga,32-327,1991,1.4,1,1,0,1,0,1,2,50,1,1,0,1,0,1,2,0,Matches
1026,Sergio Herrera,es ESP,GK,Osasuna,es La Liga,30-243,1993,17.9,0,0,0,0,0,0,1,0,1,0,0,0,0,0,11,1,Matches
1027,Yangel Herrera,ve VEN,MF,Girona,es La Liga,26-020,1998,13.9,33,16,13,15,5,14,31,45.2,17,18,6,12,13,46,30,0,Matches
1028,Patrick Herrmann,de GER,"DF,FW",M'Gladbach,de Bundesliga,32-356,1991,0.5,2,2,1,0,1,1,1,100,0,0,0,0,1,3,1,0,Matches
1029,Juan Herzog,es ESP,DF,Las Palmas,es La Liga,20-266,2003,2.2,5,4,4,1,0,3,5,60,2,3,0,3,2,7,13,0,Matches
1030,Son Heung-min,kr KOR,FW,Tottenham,eng Premier League,31-210,1992,18.8,14,8,5,4,5,6,15,40,9,2,1,1,7,21,4,0,Matches
1031,Aaron Hickey,sct SCO,DF,Brentford,eng Premier League,21-238,2002,7.9,16,9,9,3,4,7,7,100,0,7,3,4,3,19,10,0,Matches
1032,Isak Hien,se SWE,DF,Hellas Verona,it Serie A,25-021,1999,9.6,17,10,10,7,0,10,19,52.6,9,12,5,7,7,24,33,1,Matches
1033,Isak Hien,se SWE,DF,Atalanta,it Serie A,25-021,1999,0.5,3,3,1,2,0,1,1,100,0,0,0,0,0,3,1,0,Matches
1034,James Hill,eng ENG,DF,Bournemouth,eng Premier League,22-024,2002,0.8,3,2,1,2,0,1,1,100,0,1,1,0,2,5,6,0,Matches
1035,Piero Hincapié,ec ECU,DF,Leverkusen,de Bundesliga,22-025,2002,6.3,7,3,3,3,1,2,3,66.7,1,7,1,6,7,14,17,0,Matches
1036,Jack Hinshelwood,eng ENG,"DF,MF",Brighton,eng Premier League,18-298,2005,8.7,11,4,6,3,2,5,13,38.5,8,6,2,4,13,24,18,0,Matches
1037,Adam Hložek,cz CZE,"FW,MF",Leverkusen,de Bundesliga,21-193,2002,1.8,4,2,1,2,1,3,4,75,1,0,0,0,2,6,0,0,Matches
1038,Nicolas Höfler,de GER,MF,Freiburg,de Bundesliga,33-331,1990,12.2,23,17,15,6,2,8,21,38.1,13,15,7,8,17,40,24,0,Matches
1039,Jonas Hofmann,de GER,MF,Leverkusen,de Bundesliga,31-204,1992,17.1,15,10,4,8,3,7,17,41.2,10,13,0,13,6,21,5,0,Matches
1040,Philipp Hofmann,de GER,FW,Bochum,de Bundesliga,30-310,1993,9.1,8,3,2,5,1,4,6,66.7,2,4,0,4,1,9,12,0,Matches
1041,Lucas Höler,de GER,"FW,MF",Freiburg,de Bundesliga,29-208,1994,15,21,14,10,6,5,2,10,20,8,11,2,9,10,31,16,0,Matches
1042,Fabian Holland,de GER,"MF,DF",Darmstadt 98,de Bundesliga,33-207,1990,14,33,19,15,14,4,15,26,57.7,11,13,6,7,17,50,22,0,Matches
1043,Benedict Hollerbach,de GER,"FW,MF",Union Berlin,de Bundesliga,22-262,2001,5.5,9,6,4,4,1,4,13,30.8,9,16,0,16,1,10,2,0,Matches
1044,Emil Holm,se SWE,DF,Atalanta,it Serie A,23-266,2000,4.8,11,9,6,3,2,4,18,22.2,14,12,1,11,7,18,8,0,Matches
1045,Gerrit Holtmann,ph PHI,FW,Darmstadt 98,de Bundesliga,28-315,1995,0.2,1,0,0,1,0,1,1,100,0,1,0,1,0,1,0,0,Matches
1046,Martin Hongla,cm CMR,MF,Hellas Verona,it Serie A,25-324,1998,12,24,13,9,13,2,8,11,72.7,3,8,3,5,7,31,24,0,Matches
1047,Martin Hongla,cm CMR,MF,Granada,es La Liga,25-324,1998,0,0,0,0,0,0,0,1,0,1,0,0,0,0,0,1,0,Matches
1048,Franck Honorat,fr FRA,"DF,FW",M'Gladbach,de Bundesliga,27-176,1996,16.4,15,8,8,6,1,6,11,54.5,5,14,1,13,6,21,21,1,Matches
1049,Mathias Honsak,at AUT,"MF,FW",Darmstadt 98,de Bundesliga,27-045,1996,6.6,6,4,3,2,1,4,10,40,6,7,1,6,3,9,12,0,Matches
1050,Sydney van Hooijdonk,nl NED,FW,Bologna,it Serie A,23-362,2000,2.4,3,0,0,2,1,1,2,50,1,1,1,0,1,4,4,0,Matches
1051,Fraser Hornby,sct SCO,"FW,MF",Darmstadt 98,de Bundesliga,24-143,1999,2.4,0,0,0,0,0,0,1,0,1,2,1,1,0,0,4,0,Matches
1052,Lukáš Hrádecký,fi FIN,GK,Leverkusen,de Bundesliga,34-071,1989,18,0,0,0,0,0,0,1,0,1,1,0,1,0,0,6,2,Matches
1053,Timo Hübers,de GER,DF,Köln,de Bundesliga,27-198,1996,18.9,43,33,31,10,2,29,50,58,21,36,19,17,41,84,99,0,Matches
1054,Callum Hudson-Odoi,eng ENG,"FW,MF",Nott'ham Forest,eng Premier League,23-088,2000,6.7,4,2,1,1,2,0,7,0,7,6,0,6,2,6,6,0,Matches
1055,Will Hughes,eng ENG,MF,Crystal Palace,eng Premier League,28-292,1995,12.5,36,18,17,12,7,12,27,44.4,15,23,8,15,9,45,18,0,Matches
1056,Dean Huijsen,nl NED,DF,Roma,it Serie A,18-295,2005,1.7,1,1,1,0,0,0,1,0,1,2,0,2,1,2,9,0,Matches
1057,Dean Huijsen,nl NED,DF,Juventus,it Serie A,18-295,2005,0.1,0,0,0,0,0,0,0,,0,0,0,0,0,0,1,0,Matches
1058,Mats Hummels,de GER,DF,Dortmund,de Bundesliga,35-049,1988,11.1,34,24,18,10,6,20,36,55.6,16,21,5,16,25,59,54,0,Matches
1059,Denis Huseinbasic,de GER,MF,Köln,de Bundesliga,22-215,2001,8.1,12,6,5,4,3,4,10,40,6,16,1,15,6,18,4,0,Matches
1060,Elseid Hysaj,al ALB,DF,Lazio,it Serie A,29-348,1994,5.6,14,8,5,8,1,9,14,64.3,5,8,2,6,6,20,20,0,Matches
1061,Pierre Højbjerg,dk DEN,MF,Tottenham,eng Premier League,28-182,1995,9.7,20,11,6,12,2,9,24,37.5,15,17,6,11,10,30,22,1,Matches
1062,Rasmus Højlund,dk DEN,FW,Manchester Utd,eng Premier League,20-364,2003,13.4,6,4,0,1,5,3,8,37.5,5,3,0,3,0,6,10,0,Matches
1063,Iago,br BRA,"DF,FW",Augsburg,de Bundesliga,26-317,1997,8.5,16,8,9,5,2,9,20,45,11,17,3,14,10,26,24,0,Matches
1064,Pablo Ibáñez,es ESP,MF,Osasuna,es La Liga,25-136,1998,6.2,12,6,3,5,4,2,8,25,6,9,1,8,5,17,4,0,Matches
1065,Arijon Ibrahimović,de GER,"FW,DF",Frosinone,it Serie A,18-054,2005,4.7,7,6,4,2,1,1,8,12.5,7,4,0,4,0,7,3,0,Matches
1066,Iglesias,es ESP,"DF,FW",Getafe,es La Liga,25-215,1998,9.9,25,16,15,7,3,12,17,70.6,5,9,5,4,10,35,28,0,Matches
1067,Borja Iglesias,es ESP,FW,Betis,es La Liga,31-017,1993,4.5,0,0,0,0,0,0,3,0,3,0,0,0,2,2,2,0,Matches
1068,Igor,br BRA,DF,Brighton,eng Premier League,25-361,1998,8.8,12,8,3,7,2,6,12,50,6,12,6,6,7,19,24,0,Matches
1069,Jonathan Ikone,fr FRA,FW,Fiorentina,it Serie A,25-277,1998,10.5,15,6,5,6,4,5,11,45.5,6,7,0,7,2,17,5,0,Matches
1070,Chukwubuikem Ikwuemesi,ng NGA,"FW,DF",Salernitana,it Serie A,22-182,2001,6.8,2,0,0,1,1,1,3,33.3,2,1,1,0,1,3,5,0,Matches
1071,Ivan Ilić,rs SRB,MF,Torino,it Serie A,22-323,2001,14.7,14,6,3,8,3,8,16,50,8,14,6,8,13,27,20,0,Matches
1072,Samuel Iling-Junior,eng ENG,"DF,FW",Juventus,it Serie A,20-122,2003,3,13,8,8,5,0,7,10,70,3,5,1,4,2,15,5,0,Matches
1073,Imanol,es ESP,DF,Athletic Club,es La Liga,23-240,2000,2.9,3,3,0,3,0,2,7,28.6,5,4,0,4,5,8,6,0,Matches
1074,Ciro Immobile,it ITA,FW,Lazio,it Serie A,33-348,1990,11,6,5,1,3,2,1,7,14.3,6,5,3,2,3,9,5,0,Matches
1075,Gino Infantino,ar ARG,MF,Fiorentina,it Serie A,20-260,2003,0.9,1,1,0,1,0,0,1,0,1,3,0,3,1,2,1,0,Matches
1076,Danny Ings,eng ENG,FW,West Ham,eng Premier League,31-195,1992,2.8,4,2,0,4,0,2,8,25,6,4,1,3,1,5,5,0,Matches
1077,Bonke Innocent,ng NGA,MF,Lorient,fr Ligue 1,28-014,1996,2.3,6,4,2,2,2,2,9,22.2,7,2,1,1,4,10,2,0,Matches
1078,Tim Iroegbunam,eng ENG,MF,Aston Villa,eng Premier League,20-218,2003,0.1,0,0,0,0,0,0,1,0,1,0,0,0,0,0,0,0,Matches
1079,Alexander Isak,se SWE,FW,Newcastle Utd,eng Premier League,24-135,1999,13.1,3,0,2,1,0,1,5,20,4,6,0,6,3,6,5,0,Matches
1080,Gustav Isaksen,dk DEN,FW,Lazio,it Serie A,22-290,2001,5.8,3,2,1,1,1,0,5,0,5,5,1,4,1,4,2,0,Matches
1081,Isco,es ESP,MF,Betis,es La Liga,31-288,1992,19.6,27,17,8,16,3,9,27,33.3,18,16,1,15,8,35,7,0,Matches
1082,Thomas Isherwood,se SWE,DF,Darmstadt 98,de Bundesliga,26-006,1998,3.6,7,3,3,3,1,4,5,80,1,3,2,1,5,12,16,0,Matches
1083,Ismaily,br BRA,DF,Lille,fr Ligue 1,34-023,1990,15.2,39,25,19,12,8,19,33,57.6,14,20,3,17,17,56,42,0,Matches
1084,Ardian Ismajli,al ALB,DF,Empoli,it Serie A,27-126,1996,13.3,12,7,9,3,0,7,9,77.8,2,21,14,7,15,27,68,1,Matches
1085,Ko Itakura,jp JPN,DF,M'Gladbach,de Bundesliga,27-007,1997,6.8,12,7,6,6,0,6,11,54.5,5,15,7,8,12,24,22,0,Matches
1086,Hiroki Ito,jp JPN,DF,Stuttgart,de Bundesliga,24-267,1999,10.9,4,4,3,1,0,3,8,37.5,5,11,5,6,16,20,30,0,Matches
1087,Junya Ito,jp JPN,FW,Reims,fr Ligue 1,30-331,1993,16.8,19,10,7,8,4,6,23,26.1,17,11,1,10,7,26,5,0,Matches
1088,Alex Iwobi,ng NGA,MF,Everton,eng Premier League,27-276,1996,1.6,2,0,1,0,1,2,3,66.7,1,2,0,2,1,3,0,0,Matches
1089,Alex Iwobi,ng NGA,"FW,MF",Fulham,eng Premier League,27-276,1996,12.3,14,9,6,7,1,6,12,50,6,6,0,6,11,25,5,0,Matches
1090,Armando Izzo,it ITA,DF,Monza,it Serie A,31-338,1992,5.2,11,7,6,5,0,4,10,40,6,5,3,2,8,19,8,1,Matches
1091,Nicolas Jackson,sn SEN,FW,Chelsea,eng Premier League,22-228,2001,16.1,8,7,0,4,4,0,11,0,11,11,4,7,3,11,13,0,Matches
1092,Jérémy Jacquet,fr FRA,MF,Rennes,fr Ligue 1,18-205,2005,0.1,1,1,1,0,0,0,1,0,1,0,0,0,1,2,0,0,Matches
1093,Lee Jae-sung,kr KOR,MF,Mainz 05,de Bundesliga,31-177,1992,12.4,12,7,4,7,1,5,23,21.7,18,13,1,12,15,27,12,0,Matches
1094,Paul Jaeckel,de GER,DF,Union Berlin,de Bundesliga,25-196,1998,2.4,7,2,4,3,0,5,8,62.5,3,2,1,1,4,11,5,0,Matches
1095,Filip Jagiełło,pl POL,MF,Genoa,it Serie A,26-179,1997,0.4,0,0,0,0,0,0,1,0,1,1,1,0,1,1,0,0,Matches
1096,Kristijan Jakić,hr CRO,MF,Augsburg,de Bundesliga,26-265,1997,1.3,6,2,4,1,1,3,8,37.5,5,2,0,2,1,7,1,0,Matches
1097,Kristijan Jakić,hr CRO,"MF,FW",Eint Frankfurt,de Bundesliga,26-265,1997,2.2,3,3,1,2,0,1,3,33.3,2,1,0,1,2,5,2,0,Matches
1098,Ismail Jakobs,sn SEN,DF,Monaco,fr Ligue 1,24-170,1999,10.9,35,25,15,14,6,18,29,62.1,11,10,1,9,9,44,29,0,Matches
1099,Ablie Jallow,gm GAM,"MF,FW",Metz,fr Ligue 1,25-081,1998,7.8,5,3,0,3,2,1,3,33.3,2,3,0,3,5,10,2,0,Matches
1100,Reece James,eng ENG,DF,Chelsea,eng Premier League,24-057,1999,4.3,13,8,10,2,1,8,10,80,2,4,4,0,3,16,7,1,Matches
1101,Vitaly Janelt,de GER,"MF,DF",Brentford,eng Premier League,25-269,1998,19.1,35,20,14,14,7,20,43,46.5,23,17,4,13,17,52,36,0,Matches
1102,Jakub Jankto,cz CZE,"MF,FW",Cagliari,it Serie A,28-015,1996,5.8,8,5,6,1,1,6,10,60,4,2,0,2,4,12,16,0,Matches
1103,Tony Jantschke,de GER,"DF,MF",M'Gladbach,de Bundesliga,33-302,1990,0.2,1,1,1,0,0,1,1,100,0,2,2,0,0,1,2,0,Matches
1104,Adnan Januzaj,be BEL,"FW,MF",Sevilla,es La Liga,28-363,1995,2.1,2,2,2,0,0,0,1,0,1,2,0,2,1,3,0,0,Matches
1105,Mikel Jauregizar,es ESP,MF,Athletic Club,es La Liga,20-083,2003,0.7,,0,,,,,,,,,,,0,,,,Matches
1106,Luis Javier Suárez,co COL,"FW,MF",Almería,es La Liga,26-063,1997,8,5,4,2,3,0,1,4,25,3,9,0,9,0,5,9,0,Matches
1107,Danley Jean-Jacques,ht HAI,MF,Metz,fr Ligue 1,23-259,2000,17.2,34,19,17,14,3,15,38,39.5,23,29,3,26,29,63,20,0,Matches
1108,Jeffinho,br BRA,"FW,MF",Lyon,fr Ligue 1,24-035,1999,3.4,11,4,3,5,3,4,11,36.4,7,1,0,1,0,11,0,0,Matches
1109,Fredrik Jensen,fi FIN,"FW,MF",Augsburg,de Bundesliga,26-147,1997,9.7,19,8,7,7,5,11,20,55,9,16,1,15,8,27,10,0,Matches
1110,Mathias Jensen,dk DEN,MF,Brentford,eng Premier League,28-033,1996,12.6,31,17,16,13,2,14,46,30.4,32,22,3,19,11,42,13,1,Matches
1111,Moritz Jenz,de GER,DF,Wolfsburg,de Bundesliga,24-279,1999,11.5,19,14,11,7,1,6,9,66.7,3,15,10,5,18,37,65,0,Matches
1112,Gabriel Jesus,br BRA,FW,Arsenal,eng Premier League,26-306,1997,12.1,19,13,10,4,5,3,13,23.1,10,16,1,15,7,26,7,0,Matches
1113,Juan Jesus,br BRA,DF,Napoli,it Serie A,32-238,1991,11.5,19,8,15,3,1,10,15,66.7,5,12,6,6,10,29,39,0,Matches
1114,Alejandro Jiménez,es ESP,DF,Milan,it Serie A,18-271,2005,0.6,2,1,2,0,0,2,5,40,3,0,0,0,0,2,2,0,Matches
1115,Raúl Jiménez,mx MEX,FW,Fulham,eng Premier League,32-274,1991,13.8,13,10,3,7,3,6,17,35.3,11,9,2,7,3,16,12,0,Matches
1116,João Pedro,br BRA,"FW,MF",Brighton,eng Premier League,22-130,2001,14.5,23,13,7,11,5,9,17,52.9,8,9,1,8,8,31,22,0,Matches
1117,Joelinton,br BRA,"MF,FW",Newcastle Utd,eng Premier League,27-173,1996,12.6,30,22,16,12,2,10,30,33.3,20,19,5,14,17,47,11,1,Matches
1118,Ryan John Giles,eng ENG,"DF,MF",Luton Town,eng Premier League,24-008,2000,5.6,8,6,4,3,1,2,7,28.6,5,2,0,2,4,12,22,0,Matches
1119,Ben Johnson,eng ENG,"DF,MF",West Ham,eng Premier League,24-010,2000,2.2,5,4,4,1,0,4,5,80,1,0,0,0,2,7,7,0,Matches
1120,Brennan Johnson,wls WAL,FW,Tottenham,eng Premier League,22-256,2001,10.8,12,8,8,3,1,7,17,41.2,10,16,0,16,6,18,9,1,Matches
1121,Brennan Johnson,wls WAL,"FW,MF",Nott'ham Forest,eng Premier League,22-256,2001,2.6,4,1,1,1,2,2,4,50,2,4,1,3,0,4,0,0,Matches
1122,Sam Johnstone,eng ENG,GK,Crystal Palace,eng Premier League,30-315,1993,16,1,0,1,0,0,1,1,100,0,0,0,0,0,1,3,0,Matches
1123,Curtis Jones,eng ENG,MF,Liverpool,eng Premier League,23-004,2001,8.3,18,10,10,6,2,7,16,43.8,9,16,0,16,5,23,7,0,Matches
1124,Frenkie de Jong,nl NED,"MF,DF",Barcelona,es La Liga,26-267,1997,13.4,32,21,12,16,4,7,17,41.2,10,14,7,7,11,43,13,1,Matches
1125,Joan Jordán,es ESP,MF,Sevilla,es La Liga,29-212,1994,3.8,7,6,2,3,2,6,14,42.9,8,4,2,2,4,11,2,0,Matches
1126,Jordi,es ESP,MF,Getafe,es La Liga,23-029,2001,2.8,6,6,1,5,0,3,5,60,2,2,0,2,5,11,5,0,Matches
1127,Kaio Jorge,br BRA,FW,Frosinone,it Serie A,22-010,2002,5.8,1,1,0,0,1,1,2,50,1,3,0,3,0,1,0,0,Matches
1128,Jorginho,it ITA,MF,Arsenal,eng Premier League,32-045,1991,4.5,13,4,5,3,5,8,15,53.3,7,9,1,8,2,15,2,1,Matches
1129,Willian José,br BRA,FW,Betis,es La Liga,32-072,1991,11.8,6,2,1,2,3,1,3,33.3,2,6,1,5,0,6,8,0,Matches
1130,Joselu,es ESP,FW,Real Madrid,es La Liga,33-313,1990,11.6,5,3,1,3,1,0,2,0,2,6,0,6,5,10,6,0,Matches
1131,Diogo Jota,pt POR,FW,Liverpool,eng Premier League,27-061,1996,9.2,17,10,4,10,3,7,18,38.9,11,5,1,4,4,21,4,0,Matches
1132,Antoine Joujou,fr FRA,"MF,FW",Le Havre,fr Ligue 1,20-328,2003,5.4,14,10,5,6,3,8,16,50,8,5,1,4,2,16,4,0,Matches
1133,Luka Jović,rs SRB,FW,Milan,it Serie A,26-042,1997,5.6,4,3,0,3,1,2,4,50,2,3,0,3,0,4,8,0,Matches
1134,Juanpe,es ESP,DF,Girona,es La Liga,32-279,1991,3.4,4,3,3,1,0,3,4,75,1,10,7,3,1,5,29,0,Matches
1135,Mads Juel Andersen,dk DEN,DF,Luton Town,eng Premier League,26-038,1997,4.4,6,5,4,2,0,4,4,100,0,9,6,3,8,14,29,0,Matches
1136,Christopher Jullien,fr FRA,DF,Montpellier,fr Ligue 1,30-318,1993,7.9,6,4,5,1,0,4,10,40,6,15,12,3,7,13,67,1,Matches
1137,Anthony Jung,de GER,"DF,FW",Werder Bremen,de Bundesliga,32-092,1991,16.4,20,11,13,6,1,9,17,52.9,8,21,8,13,15,35,58,0,Matches
1138,Eli Junior Kroupi,fr FRA,FW,Lorient,fr Ligue 1,17-225,2006,9.6,5,4,1,1,3,0,7,0,7,3,0,3,9,14,4,0,Matches
1139,Hamed Junior Traorè,ci CIV,MF,Bournemouth,eng Premier League,23-352,2000,0.5,1,0,1,0,0,1,3,33.3,2,3,0,3,0,1,0,0,Matches
1140,Vinicius Júnior,br BRA,FW,Real Madrid,es La Liga,23-206,2000,11.3,8,5,3,2,3,0,7,0,7,6,0,6,0,8,3,1,Matches
1141,Josip Juranović,hr CRO,DF,Union Berlin,de Bundesliga,28-171,1995,7.6,10,6,4,5,1,3,8,37.5,5,5,1,4,2,12,16,0,Matches
1142,Julian Justvan,de GER,"FW,MF",Hoffenheim,de Bundesliga,25-307,1998,0.5,1,0,1,0,0,1,2,50,1,1,0,1,0,1,0,0,Matches
1143,Julian Justvan,de GER,FW,Darmstadt 98,de Bundesliga,25-307,1998,2,2,1,0,1,1,1,4,25,3,2,0,2,2,4,0,0,Matches
1144,Filip Jørgensen,dk DEN,GK,Villarreal,es La Liga,21-293,2002,22,3,1,3,0,0,3,4,75,1,0,0,0,1,4,9,3,Matches
1145,Mathias Jørgensen,dk DEN,DF,Brentford,eng Premier League,33-286,1990,2.1,3,2,3,0,0,1,3,33.3,2,2,1,1,3,6,6,0,Matches
1146,Mohamed Kaba,fr FRA,MF,Lecce,it Serie A,22-099,2001,13.4,32,19,11,13,8,14,28,50,14,19,3,16,11,43,11,0,Matches
1147,Sory Kaba,gn GUI,FW,Las Palmas,es La Liga,28-190,1995,6.5,1,0,0,1,0,0,5,0,5,4,0,4,0,1,8,0,Matches
1148,Ozan Kabak,tr TUR,DF,Hoffenheim,de Bundesliga,23-315,2000,12.7,24,19,16,6,2,13,18,72.2,5,20,9,11,23,47,49,1,Matches
1149,Christian Kabasele,be BEL,DF,Udinese,it Serie A,32-344,1991,9.5,10,7,4,5,1,2,11,18.2,9,14,8,6,12,22,56,0,Matches
1150,Issa Kaboré,bf BFA,DF,Luton Town,eng Premier League,22-267,2001,11.6,33,18,18,10,5,15,27,55.6,12,13,5,8,12,45,31,2,Matches
1151,Abdoul Kader Bamba,fr FRA,"MF,FW",Nantes,fr Ligue 1,29-254,1994,4.4,9,6,2,4,3,4,7,57.1,3,4,0,4,3,12,4,0,Matches
1152,Pavel Kadeřábek,cz CZE,"DF,FW",Hoffenheim,de Bundesliga,31-284,1992,13.3,16,9,7,8,1,10,21,47.6,11,12,4,8,12,28,31,0,Matches
1153,Tino Kadewere,zw ZIM,"FW,MF",Lyon,fr Ligue 1,28-029,1996,3.3,1,1,0,1,0,1,5,20,4,3,1,2,5,6,7,0,Matches
1154,Tino Kadewere,zw ZIM,"MF,FW",Nantes,fr Ligue 1,28-029,1996,1.9,1,1,1,0,0,1,1,100,0,4,0,4,1,2,1,0,Matches
1155,Kaiky,br BRA,DF,Almería,es La Liga,20-022,2004,5.8,7,4,6,0,1,3,6,50,3,9,7,2,3,10,29,1,Matches
1156,Florian Kainz,at AUT,"MF,FW",Köln,de Bundesliga,31-102,1992,14.7,20,14,6,8,6,13,25,52,12,14,5,9,9,29,12,0,Matches
1157,Sasa Kalajdzic,at AUT,FW,Wolves,eng Premier League,26-211,1997,1.8,6,2,3,2,1,1,2,50,1,3,0,3,1,7,6,0,Matches
1158,Sasa Kalajdzic,at AUT,FW,Eint Frankfurt,de Bundesliga,26-211,1997,2.7,1,1,0,1,0,0,0,,0,1,1,0,0,1,4,0,Matches
1159,Arnaud Kalimuendo,fr FRA,FW,Rennes,fr Ligue 1,22-014,2002,12.4,3,2,1,1,1,2,4,50,2,5,2,3,3,6,2,0,Matches
1160,Yayah Kallon,sl SLE,FW,Hellas Verona,it Serie A,22-218,2001,0,0,0,0,0,0,0,0,,0,0,0,0,0,0,0,0,Matches
1161,Gedeon Kalulu,cd COD,DF,Lorient,fr Ligue 1,26-158,1997,8.2,18,13,11,6,1,8,16,50,8,12,2,10,3,21,25,0,Matches
1162,Pierre Kalulu,fr FRA,DF,Milan,it Serie A,23-243,2000,1.2,4,0,2,2,0,0,1,0,1,3,2,1,1,5,6,1,Matches
1163,Daichi Kamada,jp JPN,MF,Lazio,it Serie A,27-182,1996,8.1,27,18,11,11,5,13,24,54.2,11,9,3,6,5,32,5,0,Matches
1164,Waren Kamanzi,no NOR,"DF,FW",Toulouse,fr Ligue 1,23-084,2000,5.4,16,14,8,6,2,7,14,50,7,5,1,4,3,19,19,0,Matches
1165,Boubacar Kamara,fr FRA,MF,Aston Villa,eng Premier League,24-072,1999,16.6,41,28,15,20,6,22,41,53.7,19,17,5,12,18,59,15,0,Matches
1166,Hassane Kamara,ci CIV,DF,Udinese,it Serie A,29-335,1994,13.4,26,18,17,5,4,14,20,70,6,17,1,16,15,41,32,0,Matches
1167,Willy Kambwala,fr FRA,DF,Manchester Utd,eng Premier League,19-162,2004,0.9,1,0,0,1,0,1,1,100,0,1,1,0,0,1,4,0,Matches
1168,Jakub Kamiński,pl POL,"FW,MF",Wolfsburg,de Bundesliga,21-243,2002,3.3,11,4,11,0,0,2,5,40,3,3,0,3,2,13,3,0,Matches
1169,Thomas Kaminski,be BEL,GK,Luton Town,eng Premier League,31-103,1992,21,0,0,0,0,0,0,1,0,1,0,0,0,0,0,9,1,Matches
1170,Kevin Kampl,si SVN,MF,RB Leipzig,de Bundesliga,33-117,1990,10.9,15,8,5,8,2,8,16,50,8,14,5,9,9,24,9,1,Matches
1171,Harry Kane,eng ENG,FW,Bayern Munich,de Bundesliga,30-190,1993,18.6,7,4,3,2,2,4,14,28.6,10,6,1,5,4,11,11,0,Matches
1172,Lee Kang-in,kr KOR,"MF,FW",Paris S-G,fr Ligue 1,22-349,2001,8.8,18,9,4,6,8,11,23,47.8,12,5,0,5,4,22,1,0,Matches
1173,Yann Karamoh,fr FRA,"MF,FW",Torino,it Serie A,25-210,1998,1.8,1,0,0,0,1,0,0,,0,0,0,0,0,1,1,0,Matches
1174,Atakan Karazor,de GER,MF,Stuttgart,de Bundesliga,27-113,1996,16.9,50,30,16,27,7,21,35,60,14,17,4,13,21,71,26,0,Matches
1175,Ayman Kari,fr FRA,"MF,FW",Lorient,fr Ligue 1,19-076,2004,2,4,3,1,3,0,3,5,60,2,4,2,2,1,5,2,0,Matches
1176,Emir Karic,at AUT,DF,Darmstadt 98,de Bundesliga,26-239,1997,8.4,25,17,13,6,6,14,20,70,6,16,1,15,7,32,15,0,Matches
1177,Jesper Karlsson,se SWE,FW,Bologna,it Serie A,25-193,1998,3.5,3,3,2,1,0,2,8,25,6,4,0,4,3,6,1,0,Matches
1178,Jon Karrikaburu,es ESP,"MF,FW",Alavés,es La Liga,21-137,2002,0.2,0,0,0,0,0,0,0,,0,0,0,0,0,0,0,0,Matches
1179,Rick Karsdorp,nl NED,DF,Roma,it Serie A,28-357,1995,8.9,17,13,7,4,6,10,16,62.5,6,5,2,3,6,23,9,0,Matches
1180,Grigoris Kastanos,cy CYP,"MF,DF",Salernitana,it Serie A,26-004,1998,11.2,18,11,7,5,6,7,15,46.7,8,8,2,6,8,26,4,0,Matches
1181,Silas Katompa,cd COD,"FW,MF",Stuttgart,de Bundesliga,25-120,1998,8.1,3,2,2,1,0,2,7,28.6,5,8,0,8,0,3,3,0,Matches
1182,Panos Katseris,gr GRE,DF,Lorient,fr Ligue 1,22-213,2001,0.9,1,0,1,0,0,0,1,0,1,2,2,0,0,1,0,0,Matches
1183,Mikkel Kaufmann,dk DEN,"FW,DF",Union Berlin,de Bundesliga,23-031,2001,1.9,0,0,0,0,0,0,3,0,3,2,0,2,0,0,1,0,Matches
1184,Michael Kayode,it ITA,DF,Fiorentina,it Serie A,19-208,2004,11.6,26,16,13,7,6,15,22,68.2,7,14,7,7,9,35,29,1,Matches
1185,Moise Kean,it ITA,FW,Juventus,it Serie A,23-340,2000,5.2,7,4,3,2,2,1,2,50,1,2,1,1,1,8,4,0,Matches
1186,Michael Keane,eng ENG,DF,Everton,eng Premier League,31-023,1993,4.5,7,3,3,3,1,1,6,16.7,5,4,4,0,5,12,18,1,Matches
1187,Ibrahima Kebe,ml MLI,MF,Girona,es La Liga,23-185,2000,0.1,1,1,0,1,0,0,0,,0,1,0,1,1,2,0,0,Matches
1188,Kévin Keben Biakolo,cm CMR,DF,Toulouse,fr Ligue 1,20-008,2004,1.4,1,1,1,0,0,1,2,50,1,2,0,2,2,3,7,0,Matches
1189,Yassine Kechta,ma MAR,MF,Le Havre,fr Ligue 1,21-343,2002,10.2,26,9,13,12,1,15,42,35.7,27,9,3,6,12,38,3,0,Matches
1190,Thilo Kehrer,de GER,"DF,MF",West Ham,eng Premier League,27-135,1996,0.2,1,1,0,1,0,0,0,,0,2,2,0,0,1,0,0,Matches
1191,Thilo Kehrer,de GER,DF,Monaco,fr Ligue 1,27-135,1996,2,3,3,3,0,0,1,7,14.3,6,5,0,5,3,6,6,0,Matches
1192,Habib Keita,ml MLI,MF,Clermont Foot,fr Ligue 1,21-363,2002,6.9,18,12,5,10,3,8,12,66.7,4,19,7,12,19,37,16,0,Matches
1193,Naby Keïta,gn GUI,MF,Werder Bremen,de Bundesliga,28-358,1995,0.9,0,0,0,0,0,0,1,0,1,1,0,1,1,1,0,0,Matches
1194,Yannik Keitel,de GER,MF,Freiburg,de Bundesliga,23-353,2000,1.4,7,5,3,3,1,3,4,75,1,4,0,4,4,11,4,1,Matches
1195,Caoimhín Kelleher,ie IRL,GK,Liverpool,eng Premier League,25-072,1998,2,0,0,0,0,0,0,0,,0,0,0,0,0,0,2,1,Matches
1196,Thomas Keller,de GER,"MF,FW",Heidenheim,de Bundesliga,24-182,1999,0,0,0,0,0,0,0,0,,0,0,0,0,0,0,0,0,Matches
1197,Lloyd Kelly,eng ENG,DF,Bournemouth,eng Premier League,25-120,1998,8.8,17,14,6,9,2,10,18,55.6,8,13,7,6,6,23,26,0,Matches
1198,Aljoscha Kemlein,de GER,MF,Union Berlin,de Bundesliga,19-185,2004,0.3,0,0,0,0,0,0,3,0,3,1,0,1,0,0,0,0,Matches
1199,Tobias Kempe,de GER,MF,Darmstadt 98,de Bundesliga,34-221,1989,9.3,8,8,5,3,0,4,10,40,6,7,1,6,6,14,6,0,Matches
1200,Milos Kerkez,hu HUN,DF,Bournemouth,eng Premier League,20-088,2003,13,33,18,21,10,2,20,29,69,9,21,7,14,10,43,38,1,Matches
1201,Reda Khadra,de GER,"FW,MF",Reims,fr Ligue 1,22-214,2001,5.4,3,1,0,0,3,2,7,28.6,5,3,0,3,2,5,5,0,Matches
1202,Wahbi Khazri,tn TUN,FW,Montpellier,fr Ligue 1,32-360,1991,8.3,19,12,6,11,2,12,25,48,13,8,0,8,3,22,4,0,Matches
1203,Rani Khedira,de GER,MF,Union Berlin,de Bundesliga,30-007,1994,4,9,5,4,5,0,4,6,66.7,2,3,0,3,5,14,10,0,Matches
1204,Kiké,es ESP,FW,Alavés,es La Liga,34-070,1989,10.2,2,1,0,1,1,2,7,28.6,5,10,4,6,0,2,10,0,Matches
1205,Luca Kilian,de GER,DF,Köln,de Bundesliga,24-155,1999,3.1,10,5,9,1,0,5,7,71.4,2,7,3,4,1,11,8,0,Matches
1206,Max Kilman,eng ENG,DF,Wolves,eng Premier League,26-256,1997,22,30,15,26,3,1,17,22,77.3,5,36,17,19,23,53,107,2,Matches
1207,Joshua Kimmich,de GER,MF,Bayern Munich,de Bundesliga,28-360,1995,12.2,24,17,8,11,5,13,20,65,7,15,2,13,10,34,10,1,Matches
1208,Jakub Kiwior,pl POL,DF,Arsenal,eng Premier League,23-353,2000,3.4,8,6,4,4,0,5,6,83.3,1,4,1,3,1,9,12,0,Matches
1209,Simon Kjær,dk DEN,DF,Milan,it Serie A,34-314,1989,9.4,18,11,8,8,2,12,16,75,4,17,13,4,9,27,35,0,Matches
1210,Davy Klaassen,nl NED,"MF,FW",Inter,it Serie A,30-347,1993,0.8,2,1,0,2,0,0,0,,0,0,0,0,0,2,0,0,Matches
1211,Christoph Klarer,at AUT,DF,Darmstadt 98,de Bundesliga,23-234,2000,16,23,14,18,2,3,13,23,56.5,10,19,9,10,10,33,48,1,Matches
1212,Tim Kleindienst,de GER,FW,Heidenheim,de Bundesliga,28-156,1995,19.5,14,9,4,8,2,5,18,27.8,13,15,5,10,9,23,34,0,Matches
1213,Lukas Klostermann,de GER,DF,RB Leipzig,de Bundesliga,27-245,1996,11.7,13,8,6,6,1,4,11,36.4,7,17,8,9,8,21,49,1,Matches
1214,Justin Kluivert,nl NED,"MF,FW",Bournemouth,eng Premier League,24-274,1999,10,17,9,3,8,6,4,18,22.2,14,6,0,6,5,22,5,0,Matches
1215,Ansgar Knauff,de GER,"MF,FW",Eint Frankfurt,de Bundesliga,22-024,2002,11.8,26,16,11,10,5,10,20,50,10,19,3,16,8,34,9,0,Matches
1216,Robin Knoche,de GER,DF,Union Berlin,de Bundesliga,31-257,1992,14.6,30,19,24,6,0,16,26,61.5,10,14,9,5,9,39,44,0,Matches
1217,Gregor Kobel,ch SUI,GK,Dortmund,de Bundesliga,26-059,1997,17.3,0,0,0,0,0,0,1,0,1,0,0,0,0,0,9,0,Matches
1218,Robin Koch,de GER,DF,Eint Frankfurt,de Bundesliga,27-201,1996,16.7,20,13,14,6,0,10,13,76.9,3,21,15,6,19,39,87,0,Matches
1219,Philipp Köhn,ch SUI,GK,Monaco,fr Ligue 1,25-307,1998,19,1,1,1,0,0,1,1,100,0,0,0,0,1,2,4,2,Matches
1220,Dominik Kohr,de GER,"MF,DF",Mainz 05,de Bundesliga,30-003,1994,13.3,34,22,20,12,2,16,31,51.6,15,17,4,13,26,60,30,0,Matches
1221,Koke,es ESP,MF,Atlético Madrid,es La Liga,32-026,1992,14.4,39,29,16,18,5,22,44,50,22,19,9,10,10,49,17,1,Matches
1222,Sead Kolašinac,ba BIH,DF,Atalanta,it Serie A,30-228,1993,15.2,27,19,18,8,1,20,32,62.5,12,11,4,7,16,43,28,0,Matches
1223,Luca Koleosho,it ITA,"MF,FW",Burnley,eng Premier League,19-141,2004,10.8,7,4,2,5,0,2,10,20,8,13,0,13,2,9,0,0,Matches
1224,Randal Kolo Muani,fr FRA,"FW,MF",Paris S-G,fr Ligue 1,25-060,1998,7.1,6,5,4,2,0,3,8,37.5,5,4,0,4,3,9,7,0,Matches
1225,Randal Kolo Muani,fr FRA,FW,Eint Frankfurt,de Bundesliga,25-060,1998,1.7,0,0,0,0,0,0,0,,0,0,0,0,0,0,1,0,Matches
1226,Cheick Konaté,ci CIV,DF,Clermont Foot,fr Ligue 1,19-337,2004,10.6,24,14,17,7,0,19,34,55.9,15,15,2,13,12,36,18,0,Matches
1227,Ibrahima Konaté,fr FRA,DF,Liverpool,eng Premier League,24-254,1999,11.8,25,17,13,11,1,13,18,72.2,5,13,8,5,10,35,36,0,Matches
1228,Geoffrey Kondogbia,cf CTA,MF,Marseille,fr Ligue 1,30-353,1993,10,26,16,11,12,3,7,19,36.8,12,14,2,12,22,48,17,0,Matches
1229,Amadou Koné,ml MLI,MF,Reims,fr Ligue 1,18-265,2005,1.7,4,3,4,0,0,1,3,33.3,2,1,0,1,2,6,6,0,Matches
1230,Ibrahima Koné,ml MLI,FW,Almería,es La Liga,24-232,1999,2.9,1,0,1,0,0,1,1,100,0,1,0,1,0,1,4,0,Matches
1231,Ibrahima Koné,ml MLI,FW,Lorient,fr Ligue 1,24-232,1999,0.4,0,0,0,0,0,0,1,0,1,0,0,0,0,0,0,0,Matches
1232,Kouadio Koné,fr FRA,MF,M'Gladbach,de Bundesliga,22-262,2001,9.4,26,15,11,11,4,10,16,62.5,6,13,0,13,7,33,5,1,Matches
1233,Ezri Konsa,eng ENG,DF,Aston Villa,eng Premier League,26-103,1997,21.5,33,20,19,12,2,16,18,88.9,2,24,14,10,22,55,47,2,Matches
1234,Teun Koopmeiners,nl NED,MF,Atalanta,it Serie A,25-340,1998,17.6,24,15,7,13,4,13,35,37.1,22,20,2,18,7,31,24,0,Matches
1235,Odilon Kossonou,ci CIV,DF,Leverkusen,de Bundesliga,23-030,2001,13.4,22,16,9,9,4,8,13,61.5,5,21,2,19,23,45,28,0,Matches
1236,Filip Kostić,rs SRB,"DF,FW",Juventus,it Serie A,31-094,1992,14.6,28,18,15,10,3,13,26,50,13,22,7,15,7,35,31,0,Matches
1237,Christian Kouamé,ci CIV,FW,Fiorentina,it Serie A,26-059,1997,7.6,8,2,4,4,0,3,5,60,2,12,0,12,0,8,7,0,Matches
1238,Rominigue Kouamé,ml MLI,MF,Cádiz,es La Liga,27-048,1996,5.7,7,4,4,3,0,4,8,50,4,4,2,2,10,17,5,1,Matches
1239,Koffi Kouao,ci CIV,DF,Metz,fr Ligue 1,25-259,1998,7.5,15,10,8,6,1,8,14,57.1,6,6,3,3,13,28,25,1,Matches
1240,Therence Koudou,fr FRA,DF,Reims,fr Ligue 1,19-052,2004,0.4,0,0,0,0,0,0,0,,0,0,0,0,0,0,3,0,Matches
1241,Jules Koundé,fr FRA,DF,Barcelona,es La Liga,25-083,1998,16.9,19,11,11,6,2,14,23,60.9,9,14,8,6,16,35,49,3,Matches
1242,Boubakar Kouyaté,ml MLI,DF,Montpellier,fr Ligue 1,26-294,1997,12.8,26,18,18,6,2,14,32,43.8,18,17,7,10,17,43,62,1,Matches
1243,Cheikhou Kouyaté,sn SEN,MF,Nott'ham Forest,eng Premier League,34-044,1989,2.3,8,5,3,3,2,1,4,25,3,4,1,3,2,10,10,0,Matches
1244,Mateo Kovačić,hr CRO,MF,Manchester City,eng Premier League,29-273,1994,9.5,20,15,11,7,2,10,16,62.5,6,10,0,10,2,22,8,0,Matches
1245,Viktor Kovalenko,ua UKR,MF,Empoli,it Serie A,27-354,1996,3.6,5,2,2,2,1,2,4,50,2,6,1,5,1,6,5,0,Matches
1246,Matej Kovar,cz CZE,GK,Leverkusen,de Bundesliga,23-262,2000,1,0,0,0,0,0,0,0,,0,0,0,0,0,0,0,0,Matches
1247,Dawid Kownacki,pl POL,FW,Werder Bremen,de Bundesliga,26-326,1997,2.7,0,0,0,0,0,0,2,0,2,1,1,0,0,0,1,0,Matches
1248,Emil Krafth,se SWE,DF,Newcastle Utd,eng Premier League,29-185,1994,0.9,3,2,1,1,1,3,3,100,0,0,0,0,0,3,1,0,Matches
1249,Alex Král,cz CZE,MF,Union Berlin,de Bundesliga,25-260,1998,11.3,14,9,3,9,2,4,12,33.3,8,12,3,9,6,20,22,0,Matches
1250,Andrej Kramarić,hr CRO,"MF,FW",Hoffenheim,de Bundesliga,32-229,1991,13.1,3,1,2,0,1,2,6,33.3,4,6,0,6,5,8,8,0,Matches
1251,Christoph Kramer,de GER,MF,M'Gladbach,de Bundesliga,32-349,1991,2.7,10,5,5,5,0,2,14,14.3,12,7,1,6,4,14,5,0,Matches
1252,Frans Krätzig,de GER,DF,Bayern Munich,de Bundesliga,21-020,2003,0.6,2,0,2,0,0,1,2,50,1,0,0,0,0,2,0,0,Matches
1253,Tom Krauß,de GER,MF,Mainz 05,de Bundesliga,22-226,2001,10.7,40,23,14,22,4,14,39,35.9,25,20,4,16,10,50,14,0,Matches
1254,Thomas Kristensen,dk DEN,DF,Udinese,it Serie A,22-017,2002,11.3,19,15,14,5,0,9,14,64.3,5,12,8,4,21,40,62,0,Matches
1255,Toni Kroos,de GER,MF,Real Madrid,es La Liga,34-030,1990,15.3,35,19,13,16,6,20,43,46.5,23,16,2,14,10,45,7,1,Matches
1256,Nikola Krstović,me MNE,FW,Lecce,it Serie A,23-304,2000,16,12,4,3,6,3,3,6,50,3,9,3,6,2,14,16,0,Matches
1257,Rade Krunić,ba BIH,MF,Milan,it Serie A,30-119,1993,7.6,10,8,3,6,1,4,9,44.4,5,7,3,4,11,21,14,0,Matches
1258,Lukas Kübler,de GER,DF,Freiburg,de Bundesliga,31-157,1992,10.4,24,12,17,6,1,14,20,70,6,17,9,8,15,39,25,0,Matches
1259,Takefusa Kubo,jp JPN,"FW,MF",Real Sociedad,es La Liga,22-244,2001,15.7,18,14,10,5,3,6,15,40,9,17,2,15,8,26,4,1,Matches
1260,Dejan Kulusevski,se SWE,"FW,MF",Tottenham,eng Premier League,23-284,2000,19.5,35,18,13,13,9,12,40,30,28,14,1,13,9,44,2,1,Matches
1261,Sael Kumbedi,fr FRA,DF,Lyon,fr Ligue 1,18-314,2005,10.2,30,20,14,12,4,9,22,40.9,13,12,3,9,14,44,18,2,Matches
1262,Layvin Kurzawa,fr FRA,DF,Paris S-G,fr Ligue 1,31-152,1992,0.1,0,0,0,0,0,0,0,,0,0,0,0,0,0,0,0,Matches
1263,Berkan Kutlu,tr TUR,MF,Genoa,it Serie A,26-009,1998,2.2,6,4,5,1,0,3,6,50,3,3,0,3,4,10,5,0,Matches
1264,Daler Kuzyaev,ru RUS,MF,Le Havre,fr Ligue 1,31-019,1993,15.4,29,15,9,13,7,12,32,37.5,20,10,3,7,14,43,12,1,Matches
1265,Khvicha Kvaratskhelia,ge GEO,FW,Napoli,it Serie A,22-356,2001,16.3,18,10,5,8,5,7,25,28,18,7,1,6,12,30,7,0,Matches
1266,Giorgi Kvernadze,ge GEO,"FW,DF",Frosinone,it Serie A,20-361,2003,0.7,3,0,2,0,1,2,2,100,0,1,0,1,1,4,0,0,Matches
1267,Moritz-Broni Kwarteng,gh GHA,"FW,MF",Bochum,de Bundesliga,25-281,1998,1.9,1,0,0,1,0,0,4,0,4,1,0,1,1,2,0,0,Matches
1268,Grejohn Kyei,fr FRA,FW,Clermont Foot,fr Ligue 1,28-175,1995,6.9,5,3,1,2,2,2,3,66.7,1,0,0,0,0,5,4,0,Matches
1269,Giorgos Kyriakopoulos,gr GRE,"DF,MF",Monza,it Serie A,27-363,1996,13.9,14,9,11,3,0,6,15,40,9,9,0,9,10,24,19,0,Matches
1270,Luca de la Torre,us USA,MF,Celta Vigo,es La Liga,25-256,1998,14.2,28,16,9,16,3,13,28,46.4,15,16,3,13,8,36,11,0,Matches
1271,Gaëtan Laborde,fr FRA,FW,Nice,fr Ligue 1,29-276,1994,14.9,15,11,8,3,4,10,22,45.5,12,17,1,16,4,19,4,1,Matches
1272,Alexandre Lacazette,fr FRA,FW,Lyon,fr Ligue 1,32-251,1991,14.6,14,8,6,6,2,2,9,22.2,7,15,2,13,3,17,6,0,Matches
1273,Maxence Lacroix,fr FRA,DF,Wolfsburg,de Bundesliga,23-303,2000,14.4,26,15,16,10,0,16,22,72.7,6,22,9,13,17,43,78,0,Matches
1274,Alban Lafont,fr FRA,GK,Nantes,fr Ligue 1,25-011,1999,13.7,0,0,0,0,0,0,1,0,1,0,0,0,0,0,3,0,Matches
1275,Aïssa Laïdouni,tn TUN,MF,Union Berlin,de Bundesliga,27-052,1996,8,15,8,4,8,3,3,7,42.9,4,17,2,15,10,25,5,0,Matches
1276,Konrad Laimer,at AUT,"DF,MF",Bayern Munich,de Bundesliga,26-252,1997,14.1,38,22,15,14,9,17,32,53.1,15,32,4,28,15,53,10,1,Matches
1277,Stefan Lainer,at AUT,DF,M'Gladbach,de Bundesliga,31-160,1992,0.5,1,1,1,0,0,1,3,33.3,2,0,0,0,0,1,1,0,Matches
1278,Kenny Lala,fr FRA,DF,Brest,fr Ligue 1,32-123,1991,19,49,30,19,21,9,18,38,47.4,20,11,2,9,19,68,42,1,Matches
1279,Adam Lallana,eng ENG,MF,Brighton,eng Premier League,35-269,1988,5.8,5,2,2,3,0,0,3,0,3,1,0,1,2,7,1,0,Matches
1280,Mathis Lambourde,fr FRA,FW,Rennes,fr Ligue 1,18-025,2006,0.1,0,0,0,0,0,0,1,0,1,1,0,1,0,0,1,0,Matches
1281,Érik Lamela,ar ARG,"FW,MF",Sevilla,es La Liga,31-336,1992,4.1,16,10,3,8,5,7,12,58.3,5,10,0,10,0,16,4,0,Matches
1282,Mohamed Lamine Bayo,gn GUI,FW,Le Havre,fr Ligue 1,25-244,1998,9.9,6,2,1,2,3,0,7,0,7,7,1,6,1,7,10,0,Matches
1283,Tariq Lamptey,gh GHA,"DF,FW",Brighton,eng Premier League,23-126,2000,2.7,3,3,1,2,0,0,5,0,5,0,0,0,2,5,0,0,Matches
1284,Gianluca Lapadula,pe PER,"FW,MF",Cagliari,it Serie A,33-361,1990,3.1,1,1,0,0,1,1,2,50,1,1,0,1,2,3,1,0,Matches
1285,Aymeric Laporte,es ESP,DF,Manchester City,eng Premier League,29-252,1994,0.1,0,0,0,0,0,0,0,,0,1,1,0,0,0,1,0,Matches
1286,Julien Laporte,fr FRA,DF,Lorient,fr Ligue 1,30-091,1993,11.6,14,9,10,4,0,10,23,43.5,13,16,13,3,8,22,58,1,Matches
1287,Cyle Larin,ca CAN,FW,Mallorca,es La Liga,28-292,1995,12.9,10,3,4,1,5,2,5,40,3,10,2,8,1,11,9,0,Matches
1288,Yasser Larouci,dz ALG,DF,Sheffield Utd,eng Premier League,23-033,2001,3.2,12,6,7,4,1,6,9,66.7,3,5,1,4,7,19,12,0,Matches
1289,Hugo Larsson,se SWE,MF,Eint Frankfurt,de Bundesliga,19-221,2004,15.8,27,13,15,8,4,13,24,54.2,11,24,6,18,24,51,16,1,Matches
1290,Jamaal Lascelles,eng ENG,DF,Newcastle Utd,eng Premier League,30-084,1993,11.6,14,9,7,7,0,6,10,60,4,17,12,5,4,18,42,0,Matches
1291,Juanmi Latasa,es ESP,FW,Getafe,es La Liga,22-317,2001,11.9,3,3,0,2,1,0,7,0,7,4,0,4,3,6,15,0,Matches
1292,Toni Lato,es ESP,DF,Mallorca,es La Liga,26-074,1997,9.9,22,14,12,9,1,8,15,53.3,7,11,1,10,10,32,14,0,Matches
1293,Armand Lauriente,fr FRA,FW,Sassuolo,it Serie A,25-061,1998,17.6,11,8,3,6,2,8,25,32,17,12,2,10,8,19,3,0,Matches
1294,Roméo Lavia,be BEL,MF,Chelsea,eng Premier League,20-028,2004,0.4,1,0,0,1,0,0,0,,0,0,0,0,0,1,1,0,Matches
1295,Lázaro,br BRA,"FW,MF",Almería,es La Liga,21-328,2002,3.2,4,1,2,0,2,2,8,25,6,4,0,4,1,5,1,0,Matches
1296,Valentino Lazaro,at AUT,DF,Torino,it Serie A,27-316,1996,14.5,10,7,2,7,1,6,11,54.5,5,8,1,7,6,16,19,0,Matches
1297,Darko Lazović,rs SRB,"FW,DF",Hellas Verona,it Serie A,33-141,1990,9.7,12,7,7,0,5,7,13,53.8,6,3,1,2,1,13,9,0,Matches
1298,Manuel Lazzari,it ITA,DF,Lazio,it Serie A,30-066,1993,11.6,18,13,9,6,3,14,21,66.7,7,14,4,10,11,29,22,1,Matches
1299,Théo Le Bris,fr FRA,"MF,DF",Lorient,fr Ligue 1,21-125,2002,9.4,23,13,19,3,1,10,21,47.6,11,15,3,12,3,26,13,0,Matches
1300,Julien Le Cardinal,fr FRA,DF,Brest,fr Ligue 1,26-184,1997,2.2,5,4,3,1,1,2,4,50,2,2,2,0,7,12,11,0,Matches
1301,Julien Le Cardinal,fr FRA,DF,Lens,fr Ligue 1,26-184,1997,0.6,6,2,4,2,0,4,9,44.4,5,2,1,1,0,6,0,0,Matches
1302,Jérémy Le Douaron,fr FRA,FW,Brest,fr Ligue 1,25-288,1998,14,19,10,6,8,5,10,23,43.5,13,8,1,7,2,21,6,0,Matches
1303,Enzo Le Fée,fr FRA,MF,Rennes,fr Ligue 1,24-000,2000,12.9,32,22,13,13,6,16,33,48.5,17,13,2,11,14,46,16,0,Matches
1304,Vincent Le Goff,fr FRA,"DF,MF",Lorient,fr Ligue 1,34-111,1989,6,5,0,4,0,1,4,8,50,4,11,3,8,3,8,10,0,Matches
1305,Robin Le Normand,es ESP,DF,Real Sociedad,es La Liga,27-084,1996,17.5,20,16,11,9,0,11,21,52.4,10,20,12,8,20,40,56,1,Matches
1306,Nicola Leali,it ITA,GK,Genoa,it Serie A,30-351,1993,1,0,0,0,0,0,0,0,,0,0,0,0,0,0,0,0,Matches
1307,Rafael Leão,pt POR,"FW,MF",Milan,it Serie A,24-238,1999,15.5,9,8,1,5,3,2,5,40,3,11,1,10,5,14,10,0,Matches
1308,Adrien Lebeau,fr FRA,"MF,FW",Brest,fr Ligue 1,24-210,1999,0.3,0,0,0,0,0,0,1,0,1,0,0,0,0,0,1,0,Matches
1309,Benjamin Lecomte,fr FRA,GK,Montpellier,fr Ligue 1,32-283,1991,19,0,0,0,0,0,0,1,0,1,0,0,0,0,0,10,1,Matches
1310,Jeremías Ledesma,ar ARG,GK,Cádiz,es La Liga,30-355,1993,18.9,0,0,0,0,0,0,2,0,2,0,0,0,0,0,10,2,Matches
1311,Pierre Lees-Melou,fr FRA,MF,Brest,fr Ligue 1,30-254,1993,17.8,59,38,33,24,2,27,78,34.6,51,36,8,28,23,82,43,3,Matches
1312,Diogo Leite,pt POR,DF,Union Berlin,de Bundesliga,25-011,1999,17.6,27,19,17,7,3,14,31,45.2,17,26,12,14,25,52,85,0,Matches
1313,Maxim Leitsch,de GER,DF,Mainz 05,de Bundesliga,25-261,1998,4.2,6,3,5,1,0,3,6,50,3,2,0,2,4,10,13,0,Matches
1314,Florian Lejeune,fr FRA,DF,Rayo Vallecano,es La Liga,32-259,1991,22,19,10,11,7,1,8,15,53.3,7,20,9,11,13,32,88,1,Matches
1315,Iñigo Lekue,es ESP,DF,Athletic Club,es La Liga,30-275,1993,14.4,29,13,18,8,3,19,40,47.5,21,17,2,15,8,37,35,0,Matches
1316,Thomas Lemar,fr FRA,MF,Atlético Madrid,es La Liga,28-083,1995,1.8,3,1,2,1,0,1,2,50,1,0,0,0,0,3,0,0,Matches
1317,Mario Lemina,ga GAB,MF,Wolves,eng Premier League,30-155,1993,18.3,54,36,31,18,5,9,23,39.1,14,12,5,7,29,83,40,0,Matches
1318,Álvaro Lemos,es ESP,DF,Las Palmas,es La Liga,30-310,1993,2.2,4,1,1,3,0,0,1,0,1,3,1,2,2,6,4,0,Matches
1319,Clément Lenglet,fr FRA,DF,Aston Villa,eng Premier League,28-231,1995,4.7,7,6,5,2,0,5,7,71.4,2,8,3,5,3,10,13,0,Matches
1320,Bernd Leno,de GER,GK,Fulham,eng Premier League,31-336,1992,22,0,0,0,0,0,0,0,,0,0,0,0,0,0,10,0,Matches
1321,Christopher Lenz,de GER,"DF,MF",RB Leipzig,de Bundesliga,29-134,1994,0.4,1,1,1,0,0,1,1,100,0,0,0,0,1,2,2,0,Matches
1322,Christopher Lenz,de GER,DF,Eint Frankfurt,de Bundesliga,29-134,1994,0.1,1,1,0,1,0,1,1,100,0,0,0,0,0,1,1,0,Matches
1323,Johann Lepenant,fr FRA,MF,Lyon,fr Ligue 1,21-104,2002,2.8,4,3,2,2,0,1,8,12.5,7,5,0,5,4,8,0,0,Matches
1324,Jefferson Lerma,co COL,MF,Crystal Palace,eng Premier League,29-101,1994,16.5,27,16,8,16,3,9,22,40.9,13,17,5,12,19,46,31,0,Matches
1325,Léo Leroy,fr FRA,MF,Montpellier,fr Ligue 1,23-354,2000,2,11,4,3,5,3,3,7,42.9,4,3,0,3,1,12,4,0,Matches
1326,Robert Lewandowski,pl POL,FW,Barcelona,es La Liga,35-166,1988,17.6,3,2,0,2,1,2,6,33.3,4,5,2,3,2,5,11,0,Matches
1327,Jamie Leweling,de GER,"FW,MF",Stuttgart,de Bundesliga,22-342,2001,8.5,9,4,3,3,3,2,7,28.6,5,13,0,13,1,10,7,0,Matches
1328,Rico Lewis,eng ENG,"MF,DF",Manchester City,eng Premier League,19-074,2004,5,5,3,3,1,1,1,3,33.3,2,4,1,3,4,9,3,0,Matches
1329,Keane Lewis-Potter,eng ENG,"FW,DF",Brentford,eng Premier League,22-346,2001,8.4,13,5,5,7,1,4,8,50,4,4,1,3,3,16,8,0,Matches
1330,Philipp Lienhart,at AUT,DF,Freiburg,de Bundesliga,27-207,1996,13.7,18,12,12,5,1,11,20,55,9,17,10,7,13,31,50,0,Matches
1331,Matthijs de Ligt,nl NED,DF,Bayern Munich,de Bundesliga,24-175,1999,7.1,8,6,1,4,3,3,3,100,0,9,5,4,8,16,28,0,Matches
1332,Victor Lindelöf,se SWE,DF,Manchester Utd,eng Premier League,29-201,1994,10,11,6,4,7,0,4,9,44.4,5,13,8,5,8,19,23,1,Matches
1333,Jesper Lindstrøm,dk DEN,"FW,MF",Napoli,it Serie A,23-339,2000,2.6,6,2,2,1,3,4,7,57.1,3,1,0,1,2,8,3,0,Matches
1334,Jesper Lindstrøm,dk DEN,FW,Eint Frankfurt,de Bundesliga,23-339,2000,0.9,1,1,1,0,0,0,0,,0,0,0,0,0,1,0,0,Matches
1335,Karol Linetty,pl POL,MF,Torino,it Serie A,29-001,1995,9.5,15,13,4,11,0,4,14,28.6,10,17,7,10,12,27,17,0,Matches
1336,Samuel Lino,br BRA,DF,Atlético Madrid,es La Liga,24-042,1999,11.6,30,17,20,5,5,20,33,60.6,13,20,0,20,8,38,19,0,Matches
1337,Luca Lipani,it ITA,MF,Sassuolo,it Serie A,18-261,2005,0.1,0,0,0,0,0,0,0,,0,2,0,2,0,0,0,0,Matches
1338,Pol Lirola,es ESP,"DF,MF",Frosinone,it Serie A,26-174,1997,5.1,8,5,3,4,1,3,7,42.9,4,8,0,8,7,15,10,0,Matches
1339,Marcin Listkowski,pl POL,FW,Lecce,it Serie A,25-358,1998,0.1,0,0,0,0,0,0,0,,0,0,0,0,0,0,0,0,Matches
1340,Valentino Livramento,eng ENG,DF,Newcastle Utd,eng Premier League,21-083,2002,8,15,8,11,3,1,7,15,46.7,8,9,5,4,14,29,21,0,Matches
1341,Dejan Ljubicic,at AUT,"MF,FW",Köln,de Bundesliga,26-118,1997,13.8,28,18,14,10,4,14,26,53.8,12,15,2,13,10,38,4,0,Matches
1342,Javier Llabrés,es ESP,"MF,FW",Mallorca,es La Liga,21-145,2002,1.8,2,0,1,1,0,1,1,100,0,1,0,1,1,3,3,0,Matches
1343,Diego Llorente,es ESP,DF,Roma,it Serie A,30-171,1993,17,27,17,19,8,0,10,20,50,10,29,19,10,15,42,53,0,Matches
1344,Marcos Llorente,es ESP,"MF,DF",Atlético Madrid,es La Liga,29-004,1995,15.6,18,12,11,6,1,6,21,28.6,15,20,6,14,9,27,23,0,Matches
1345,Gautier Lloris,fr FRA,DF,Le Havre,fr Ligue 1,28-200,1995,17.9,27,13,23,4,0,15,27,55.6,12,34,21,13,23,50,91,1,Matches
1346,Abou Lô,sn SEN,DF,Metz,fr Ligue 1,24-032,2000,0.8,1,0,1,0,0,1,2,50,1,1,1,0,0,1,2,0,Matches
1347,Giovani Lo Celso,ar ARG,MF,Tottenham,eng Premier League,27-300,1996,4.6,16,8,6,7,3,7,10,70,3,3,1,2,4,20,2,0,Matches
1348,Stanislav Lobotka,sk SVK,MF,Napoli,it Serie A,29-070,1994,19.7,35,21,10,18,7,13,36,36.1,23,14,3,11,10,45,17,0,Matches
1349,Manuel Locatelli,it ITA,MF,Juventus,it Serie A,26-026,1998,18.8,34,18,13,18,3,17,32,53.1,15,23,9,14,14,48,43,0,Matches
1350,Bradley Locko,fr FRA,DF,Brest,fr Ligue 1,21-273,2002,18.9,61,34,33,24,4,31,49,63.3,18,17,0,17,22,83,36,0,Matches
1351,Tom Lockyer,wls WAL,DF,Luton Town,eng Premier League,29-062,1994,13,25,16,17,6,2,15,22,68.2,7,23,13,10,23,48,68,0,Matches
1352,Renan Lodi,br BRA,DF,Marseille,fr Ligue 1,25-301,1998,13.7,24,16,8,13,3,13,21,61.9,8,7,2,5,16,40,35,0,Matches
1353,Ruben Loftus-Cheek,eng ENG,MF,Milan,it Serie A,28-011,1996,13.3,15,9,4,6,5,7,15,46.7,8,14,8,6,4,19,7,0,Matches
1354,Andy Logbo,fr FRA,FW,Le Havre,fr Ligue 1,19-273,2004,2.8,0,0,0,0,0,0,3,0,3,7,3,4,0,0,2,0,Matches
1355,Enzo Loiodice,fr FRA,MF,Las Palmas,es La Liga,23-068,2000,12.7,36,22,11,18,7,10,27,37,17,12,2,10,9,45,13,1,Matches
1356,Sean Longstaff,eng ENG,MF,Newcastle Utd,eng Premier League,26-096,1997,15.1,22,12,7,11,4,13,36,36.1,23,22,4,18,7,29,13,0,Matches
1357,Ademola Lookman,ng NGA,"FW,MF",Atalanta,it Serie A,26-106,1997,12.3,5,4,0,3,2,3,10,30,7,9,0,9,4,9,0,1,Matches
1358,Noah Loosli,ch SUI,"DF,MF",Bochum,de Bundesliga,27-011,1997,2.8,8,6,6,2,0,6,8,75,2,4,0,4,4,12,16,0,Matches
1359,Anthony Lopes,pt POR,GK,Lyon,fr Ligue 1,33-125,1990,16,0,0,0,0,0,0,0,,0,0,0,0,0,0,8,0,Matches
1360,David López,es ESP,"DF,MF",Girona,es La Liga,34-117,1989,13.2,24,17,14,10,0,10,13,76.9,3,17,13,4,14,38,40,1,Matches
1361,Diego López,es ESP,"FW,MF",Valencia,es La Liga,21-266,2002,17.8,25,15,6,12,7,8,32,25,24,13,0,13,10,35,7,0,Matches
1362,Fermin López,es ESP,"MF,FW",Barcelona,es La Liga,20-268,2003,6.6,15,8,5,8,2,6,19,31.6,13,6,0,6,2,17,3,0,Matches
1363,Javi López,es ESP,"DF,MF",Alavés,es La Liga,22-033,2002,14,12,7,4,6,2,8,15,53.3,7,10,3,7,3,15,47,1,Matches
1364,Maxime Lopez,fr FRA,MF,Fiorentina,it Serie A,26-061,1997,4.1,7,3,1,4,2,2,5,40,3,1,0,1,2,9,6,0,Matches
1365,Maxime Lopez,fr FRA,MF,Sassuolo,it Serie A,26-061,1997,1.6,2,1,1,1,0,1,2,50,1,1,1,0,2,4,0,0,Matches
1366,Pau López,es ESP,GK,Marseille,fr Ligue 1,29-052,1994,18.7,0,0,0,0,0,0,1,0,1,0,0,0,0,0,5,1,Matches
1367,Unai López,es ESP,MF,Rayo Vallecano,es La Liga,28-096,1995,13.1,23,13,7,12,4,9,28,32.1,19,16,1,15,6,29,9,1,Matches
1368,Dion Lopy,sn SEN,MF,Almería,es La Liga,22-001,2002,16.1,46,28,29,14,3,12,32,37.5,20,19,5,14,11,57,19,1,Matches
1369,Anthony Losilla,fr FRA,MF,Bochum,de Bundesliga,37-330,1986,16.4,38,19,9,25,4,13,28,46.4,15,23,6,17,17,55,24,0,Matches
1370,Jordan Lotomba,ch SUI,DF,Nice,fr Ligue 1,25-127,1998,10.3,19,14,11,5,3,15,20,75,5,15,4,11,7,26,13,0,Matches
1371,Tom Louchet,fr FRA,"FW,MF",Nice,fr Ligue 1,20-275,2003,0.6,4,1,1,3,0,1,2,50,1,0,0,0,0,4,3,0,Matches
1372,Imran Louza,ma MAR,MF,Lorient,fr Ligue 1,24-278,1999,1,0,0,0,0,0,0,1,0,1,3,1,2,0,0,1,0,Matches
1373,Matteo Lovato,it ITA,DF,Salernitana,it Serie A,23-354,2000,10.5,27,14,17,8,2,16,24,66.7,8,14,7,7,18,45,41,1,Matches
1374,Dejan Lovren,hr CRO,DF,Lyon,fr Ligue 1,34-213,1989,8,9,7,6,3,0,3,7,42.9,4,6,5,1,12,21,37,0,Matches
1375,Sandi Lovrić,si SVN,MF,Udinese,it Serie A,25-312,1998,14.2,18,6,6,8,4,8,17,47.1,9,11,0,11,12,30,15,0,Matches
1376,Max Lowe,eng ENG,"DF,MF",Sheffield Utd,eng Premier League,26-268,1997,3.5,17,9,12,2,3,7,14,50,7,6,2,4,5,22,11,0,Matches
1377,Anthony Lozano,hn HON,"MF,FW",Getafe,es La Liga,30-284,1993,1,0,0,0,0,0,0,1,0,1,0,0,0,0,0,1,0,Matches
1378,Lucas,br BRA,DF,Cádiz,es La Liga,22-316,2001,10.7,31,17,21,7,3,19,34,55.9,15,18,2,16,10,41,31,0,Matches
1379,Lorenzo Lucca,it ITA,FW,Udinese,it Serie A,23-146,2000,15.1,8,4,3,4,1,3,11,27.3,8,12,2,10,2,10,17,1,Matches
1380,Jhon Lucumí,co COL,DF,Bologna,it Serie A,25-222,1998,10.1,27,17,17,10,0,18,22,81.8,4,11,5,6,1,28,33,0,Matches
1381,José Luis Gayà,es ESP,DF,Valencia,es La Liga,28-254,1995,14,56,29,33,20,3,34,54,63,20,11,1,10,7,63,27,0,Matches
1382,José Luis Morales,es ESP,"FW,MF",Villarreal,es La Liga,36-195,1987,8.7,4,3,1,3,0,2,10,20,8,6,0,6,4,8,2,0,Matches
1383,José Luis Palomino,ar ARG,DF,Atalanta,it Serie A,34-029,1990,0.3,2,1,1,1,0,1,1,100,0,2,1,1,1,3,6,0,Matches
1384,Douglas Luiz,br BRA,MF,Aston Villa,eng Premier League,25-270,1998,20.4,41,25,16,18,7,18,35,51.4,17,26,5,21,15,56,15,0,Matches
1385,Romelu Lukaku,be BEL,FW,Roma,it Serie A,30-266,1993,18.1,3,2,1,1,1,1,3,33.3,2,5,0,5,0,3,12,0,Matches
1386,Castello Lukeba,fr FRA,DF,RB Leipzig,de Bundesliga,21-048,2002,13,10,6,5,5,0,6,8,75,2,25,7,18,6,16,48,1,Matches
1387,Dodi Lukebakio,be BEL,FW,Sevilla,es La Liga,26-132,1997,8.2,4,2,2,1,1,1,5,20,4,7,2,5,2,6,1,0,Matches
1388,Saša Lukić,rs SRB,MF,Fulham,eng Premier League,27-174,1996,4.4,11,5,1,6,4,6,14,42.9,8,5,2,3,4,15,7,1,Matches
1389,Karlo Lulić,hr CRO,MF,Frosinone,it Serie A,27-269,1996,0.2,0,0,0,0,0,0,0,,0,1,0,1,1,1,0,0,Matches
1390,Andriy Lunin,ua UKR,GK,Real Madrid,es La Liga,24-357,1999,10,0,0,0,0,0,0,0,,0,0,0,0,0,0,4,0,Matches
1391,Sebastiano Luperto,it ITA,DF,Empoli,it Serie A,27-150,1996,22,26,17,18,6,2,13,19,68.4,6,28,23,5,14,40,90,1,Matches
1392,Mateus Lusuardi,br BRA,DF,Frosinone,it Serie A,20-026,2004,2.4,2,1,1,1,0,1,3,33.3,2,4,2,2,4,6,7,0,Matches
1393,Zito Luvumbo,ao ANG,"FW,MF",Cagliari,it Serie A,21-331,2002,12.2,4,3,3,0,1,1,4,25,3,10,0,10,0,4,1,0,Matches
1394,Charalambos Lykogiannis,gr GRE,DF,Bologna,it Serie A,30-104,1993,7.4,7,4,4,2,1,5,9,55.6,4,12,5,7,5,12,24,0,Matches
1395,Senne Lynen,be BEL,MF,Werder Bremen,de Bundesliga,24-349,1999,7,14,9,7,6,1,6,23,26.1,17,18,2,16,16,30,18,0,Matches
1396,Ian Maatsen,nl NED,"FW,MF",Chelsea,eng Premier League,21-330,2002,2.3,3,2,1,1,1,0,4,0,4,4,0,4,3,6,10,0,Matches
1397,Ian Maatsen,nl NED,DF,Dortmund,de Bundesliga,21-330,2002,4,8,7,4,3,1,4,6,66.7,2,4,1,3,7,15,9,0,Matches
1398,Alexis Mac Allister,ar ARG,MF,Liverpool,eng Premier League,25-041,1998,14.2,49,27,19,25,5,33,68,48.5,35,34,4,30,21,70,10,0,Matches
1399,Deiver Machado,co COL,DF,Lens,fr Ligue 1,30-154,1993,7,8,5,2,5,1,6,10,60,4,9,1,8,4,12,5,0,Matches
1400,Darwin Machís,ve VEN,MF,Cádiz,es La Liga,30-361,1993,8,21,12,6,9,6,12,21,57.1,9,6,1,5,3,24,2,0,Matches
1401,James Maddison,eng ENG,MF,Tottenham,eng Premier League,27-072,1996,10.8,18,9,2,10,6,9,17,52.9,8,8,1,7,6,24,4,1,Matches
1402,Noni Madueke,eng ENG,FW,Chelsea,eng Premier League,21-330,2002,3.4,7,5,4,2,1,5,13,38.5,8,4,0,4,1,8,6,0,Matches
1403,Pablo Maffeo,es ESP,DF,Mallorca,es La Liga,26-206,1997,12.5,27,15,14,9,4,20,36,55.6,16,7,1,6,8,35,18,0,Matches
1404,Soungoutou Magassa,fr FRA,DF,Monaco,fr Ligue 1,20-118,2003,12.4,45,22,20,25,0,19,36,52.8,17,18,4,14,19,64,34,2,Matches
1405,Giulio Maggiore,it ITA,MF,Salernitana,it Serie A,25-328,1998,11.1,29,16,12,16,1,14,27,51.9,13,15,2,13,15,44,20,0,Matches
1406,Matej Maglica,hr CRO,DF,Darmstadt 98,de Bundesliga,25-131,1998,9.8,17,10,11,6,0,11,18,61.1,7,16,5,11,14,31,47,3,Matches
1407,Giangiacomo Magnani,it ITA,DF,Hellas Verona,it Serie A,28-122,1995,16.5,17,10,11,6,0,8,15,53.3,7,27,12,15,26,43,63,0,Matches
1408,Hugo Magnetti,fr FRA,MF,Brest,fr Ligue 1,25-249,1998,14.3,30,18,10,17,3,13,31,41.9,18,13,1,12,9,39,10,0,Matches
1409,Yohann Magnin,fr FRA,MF,Clermont Foot,fr Ligue 1,26-227,1997,9.6,21,12,5,14,2,6,17,35.3,11,21,5,16,9,30,11,0,Matches
1410,Frank Magri,cm CMR,"FW,MF",Toulouse,fr Ligue 1,24-152,1999,10.8,11,6,2,6,3,6,10,60,4,6,1,5,2,13,7,0,Matches
1411,Harry Maguire,eng ENG,DF,Manchester Utd,eng Premier League,30-335,1993,9.4,10,6,7,3,0,6,11,54.5,5,20,13,7,13,23,38,0,Matches
1412,Jon Magunacelaya,es ESP,"FW,MF",Real Sociedad,es La Liga,23-205,2000,1.2,5,3,2,3,0,4,7,57.1,3,2,0,2,0,5,2,0,Matches
1413,Adel Mahamoud,km COM,FW,Nantes,fr Ligue 1,20-364,2003,0.1,0,0,0,0,0,0,1,0,1,0,0,0,0,0,0,0,Matches
1414,Arne Maier,de GER,"MF,DF",Augsburg,de Bundesliga,25-026,1999,1.3,2,2,0,1,1,1,2,50,1,3,0,3,1,3,0,0,Matches
1415,Habib Maïga,ci CIV,"MF,FW",Metz,fr Ligue 1,28-033,1996,1.6,2,2,1,0,1,1,3,33.3,2,2,0,2,4,6,2,0,Matches
1416,Mike Maignan,fr FRA,GK,Milan,it Serie A,28-215,1995,19,1,0,1,0,0,1,1,100,0,1,0,1,0,1,4,3,Matches
1417,Linton Maina,de GER,"FW,MF",Köln,de Bundesliga,24-225,1999,12.8,13,12,8,3,2,7,20,35,13,7,1,6,5,18,4,0,Matches
1418,Patrick Mainka,de GER,DF,Heidenheim,de Bundesliga,29-089,1994,20,46,28,36,9,1,19,38,50,19,35,16,19,27,73,101,0,Matches
1419,Kobbie Mainoo,eng ENG,MF,Manchester Utd,eng Premier League,18-290,2005,7,14,9,4,7,3,4,8,50,4,7,6,1,8,22,21,1,Matches
1420,Ainsley Maitland-Niles,eng ENG,"MF,DF",Lyon,fr Ligue 1,26-158,1997,5,13,6,3,6,4,7,12,58.3,5,5,1,4,6,19,7,0,Matches
1421,Lovro Majer,hr CRO,MF,Rennes,fr Ligue 1,26-017,1998,0.2,0,0,0,0,0,0,0,,0,0,0,0,0,0,1,0,Matches
1422,Lovro Majer,hr CRO,"MF,FW",Wolfsburg,de Bundesliga,26-017,1998,14.7,22,13,9,13,0,6,19,31.6,13,12,1,11,4,26,10,0,Matches
1423,Jean-Victor Makengo,fr FRA,"MF,FW",Lorient,fr Ligue 1,25-236,1998,5.3,5,4,3,2,0,2,6,33.3,4,12,1,11,8,13,5,0,Matches
1424,Jordy Makengo,fr FRA,DF,Freiburg,de Bundesliga,22-184,2001,6.2,8,4,5,2,1,4,6,66.7,2,7,1,6,7,15,23,0,Matches
1425,Antoine Makoumbou,cg CGO,MF,Cagliari,it Serie A,25-200,1998,18.7,30,17,12,14,4,10,18,55.6,8,17,3,14,9,39,16,1,Matches
1426,Nemanja Maksimović,rs SRB,MF,Getafe,es La Liga,29-008,1995,21.8,36,24,14,16,6,14,22,63.6,8,32,18,14,31,67,41,0,Matches
1427,Julián Malatini,ar ARG,DF,Werder Bremen,de Bundesliga,22-248,2001,0,0,0,0,0,0,0,0,,0,0,0,0,0,0,1,0,Matches
1428,Daniel Maldini,it ITA,MF,Monza,it Serie A,22-115,2001,0.2,0,0,0,0,0,0,1,0,1,0,0,0,0,0,0,0,Matches
1429,Daniel Maldini,it ITA,"FW,MF",Empoli,it Serie A,22-115,2001,2.9,4,2,0,2,2,2,2,100,0,5,0,5,2,6,2,0,Matches
1430,Youssef Maleh,ma MAR,MF,Empoli,it Serie A,25-165,1998,16.7,40,29,13,21,6,11,31,35.5,20,35,5,30,14,54,9,0,Matches
1431,Donyell Malen,nl NED,"FW,MF",Dortmund,de Bundesliga,25-025,1999,14.4,8,6,4,1,3,2,5,40,3,9,4,5,2,10,7,0,Matches
1432,Ruslan Malinovskyi,ua UKR,"MF,FW",Genoa,it Serie A,30-275,1993,13.6,24,14,13,7,4,15,36,41.7,21,18,5,13,2,26,10,0,Matches
1433,Lennard Maloney,us USA,MF,Heidenheim,de Bundesliga,24-118,1999,18.6,29,19,12,13,4,19,45,42.2,26,22,5,17,23,52,69,0,Matches
1434,Aaron Malouda,fr FRA,FW,Lille,fr Ligue 1,18-065,2005,0,0,0,0,0,0,0,0,,0,0,0,0,0,0,0,0,Matches
1435,Giorgi Mamardashvili,ge GEO,GK,Valencia,es La Liga,23-127,2000,22,2,2,2,0,0,2,2,100,0,0,0,0,0,2,12,1,Matches
1436,David Mamutovic,de GER,DF,Mainz 05,de Bundesliga,23-060,2000,0.1,1,1,0,1,0,1,1,100,0,0,0,0,0,1,0,0,Matches
1437,Wilson Manafá,pt POR,"DF,MF",Granada,es La Liga,29-195,1994,2.7,6,4,3,2,1,4,7,57.1,3,1,0,1,1,7,4,1,Matches
1438,Hianga Mananga Mbock,fr FRA,"MF,FW",Brest,fr Ligue 1,24-037,1999,0.1,1,0,0,0,1,1,2,50,1,0,0,0,1,2,0,0,Matches
1439,Gianluca Mancini,it ITA,DF,Roma,it Serie A,27-292,1996,19.4,22,12,13,7,2,7,19,36.8,12,17,13,4,24,46,41,0,Matches
1440,Marco Mancosu,it ITA,"MF,FW",Cagliari,it Serie A,35-165,1988,1.7,2,0,0,2,0,0,1,0,1,0,0,0,0,2,0,0,Matches
1441,Steve Mandanda,fr FRA,GK,Rennes,fr Ligue 1,38-312,1985,19,2,0,2,0,0,2,3,66.7,1,0,0,0,0,2,3,0,Matches
1442,Reinildo Mandava,mz MOZ,DF,Atlético Madrid,es La Liga,30-013,1994,2.2,5,5,3,2,0,3,3,100,0,3,1,2,3,8,11,0,Matches
1443,Aïssa Mandi,dz ALG,DF,Villarreal,es La Liga,32-104,1991,7.4,9,5,6,3,0,7,12,58.3,5,5,4,1,6,15,26,0,Matches
1444,Rolando Mandragora,it ITA,MF,Fiorentina,it Serie A,26-219,1997,9.3,16,7,5,7,4,6,13,46.2,7,8,2,6,5,21,9,0,Matches
1445,Orel Mangala,be BEL,MF,Nott'ham Forest,eng Premier League,25-322,1998,17.4,27,13,16,10,1,14,29,48.3,15,12,6,6,26,53,32,0,Matches
1446,Braydon Manu,gh GHA,MF,Darmstadt 98,de Bundesliga,26-312,1997,0.9,1,0,0,1,0,0,0,,0,1,0,1,0,1,0,0,Matches
1447,Benson Manuel,be BEL,"MF,FW",Burnley,eng Premier League,26-312,1997,0.8,2,2,1,1,0,0,0,,0,0,0,0,0,2,0,0,Matches
1448,Faitout Maouassa,fr FRA,DF,Granada,es La Liga,25-212,1998,0,1,1,0,0,1,1,1,100,0,0,0,0,0,1,0,0,Matches
1449,Faitout Maouassa,fr FRA,"MF,DF",Lens,fr Ligue 1,25-212,1998,0.8,1,1,1,0,0,1,1,100,0,1,0,1,0,1,3,0,Matches
1450,Marcão,br BRA,DF,Sevilla,es La Liga,27-243,1996,2.4,8,5,4,4,0,5,8,62.5,3,2,2,0,2,10,0,0,Matches
1451,Solly March,eng ENG,"FW,DF",Brighton,eng Premier League,29-198,1994,6.2,19,14,9,7,3,8,14,57.1,6,5,0,5,11,30,8,0,Matches
1452,Riccardo Marchizza,it ITA,DF,Frosinone,it Serie A,25-314,1998,12.8,7,6,4,3,0,3,13,23.1,10,10,2,8,7,14,33,0,Matches
1453,Gian Marco Ferrari,it ITA,DF,Sassuolo,it Serie A,31-353,1992,11.2,11,5,8,3,0,7,9,77.8,2,15,8,7,12,23,32,0,Matches
1454,Óscar de Marcos,es ESP,DF,Athletic Club,es La Liga,34-295,1989,14.9,35,24,18,14,3,25,43,58.1,18,16,4,12,8,43,20,0,Matches
1455,Alberto Marí,es ESP,FW,Valencia,es La Liga,22-207,2001,0.3,1,1,0,1,0,1,1,100,0,0,0,0,0,1,0,0,Matches
1456,José Mari,es ESP,"MF,FW",Cádiz,es La Liga,36-059,1987,0.2,2,1,0,2,0,1,2,50,1,0,0,0,0,2,0,0,Matches
1457,Pablo Marí,es ESP,DF,Monza,it Serie A,30-156,1993,13.5,27,16,22,5,0,12,16,75,4,15,9,6,14,41,54,1,Matches
1458,José María Giménez,uy URU,DF,Atlético Madrid,es La Liga,29-014,1995,8,11,5,7,4,0,4,6,66.7,2,7,6,1,8,19,45,0,Matches
1459,Mariano,do DOM,FW,Sevilla,es La Liga,30-186,1993,2.4,1,1,0,1,0,0,0,,0,1,0,1,0,1,2,0,Matches
1460,Mirko Marić,hr CRO,FW,Monza,it Serie A,28-263,1995,3.2,4,0,2,1,1,0,2,0,2,4,0,4,2,6,3,0,Matches
1461,Rafa Marín,es ESP,DF,Alavés,es La Liga,21-260,2002,15.1,15,12,11,4,0,6,13,46.2,7,19,11,8,13,28,77,1,Matches
1462,Răzvan Marin,ro ROU,MF,Empoli,it Serie A,27-256,1996,10.1,20,9,6,10,4,11,17,64.7,6,9,1,8,2,22,22,0,Matches
1463,Diego Mariño,es ESP,GK,Almería,es La Liga,33-270,1990,1,0,0,0,0,0,0,0,,0,0,0,0,0,0,1,0,Matches
1464,Guillermo Maripán,cl CHI,DF,Monaco,fr Ligue 1,29-273,1994,11.1,12,5,8,4,0,8,14,57.1,6,14,8,6,16,28,63,2,Matches
1465,Mika Màrmol,es ESP,DF,Las Palmas,es La Liga,21-216,2002,19.5,42,27,28,13,1,22,29,75.9,7,24,12,12,20,62,98,2,Matches
1466,Omar Marmoush,eg EGY,"FW,MF",Eint Frankfurt,de Bundesliga,24-361,1999,12,11,5,5,4,2,5,9,55.6,4,4,0,4,6,17,6,0,Matches
1467,Marquinhos,br BRA,"FW,MF",Nantes,fr Ligue 1,20-302,2003,1.7,3,2,2,0,1,1,4,25,3,7,2,5,6,9,1,0,Matches
1468,Marquinhos,br BRA,DF,Paris S-G,fr Ligue 1,29-265,1994,13.6,16,9,8,7,1,9,14,64.3,5,25,17,8,16,32,47,0,Matches
1469,Unai Marrero,es ESP,GK,Real Sociedad,es La Liga,22-117,2001,1.6,0,0,0,0,0,0,0,,0,0,0,0,0,0,0,0,Matches
1470,Agustín Martegani,ar ARG,MF,Salernitana,it Serie A,23-259,2000,7.6,12,7,6,3,3,6,16,37.5,10,3,1,2,4,16,7,1,Matches
1471,Eric Martel,de GER,MF,Köln,de Bundesliga,21-280,2002,15.4,44,27,20,20,4,25,42,59.5,17,33,10,23,20,64,44,0,Matches
1472,Roger Martí,es ESP,FW,Cádiz,es La Liga,33-031,1991,11.6,9,5,1,8,0,1,5,20,4,13,1,12,6,15,3,0,Matches
1473,Anthony Martial,fr FRA,FW,Manchester Utd,eng Premier League,28-060,1995,5,4,1,1,1,2,1,1,100,0,4,0,4,0,4,3,0,Matches
1474,Aarón Martín,es ESP,DF,Genoa,it Serie A,26-287,1997,6,6,3,2,4,0,2,9,22.2,7,4,1,3,4,10,6,0,Matches
1475,Iván Martín,es ESP,"MF,FW",Girona,es La Liga,24-354,1999,17.6,34,19,16,13,5,19,44,43.2,25,14,2,12,9,43,10,0,Matches
1476,Jonas Martin,fr FRA,MF,Brest,fr Ligue 1,33-300,1990,6.5,23,16,8,14,1,12,19,63.2,7,7,0,7,1,24,7,1,Matches
1477,Gabriel Martinelli,br BRA,FW,Arsenal,eng Premier League,22-230,2001,15.4,18,14,3,7,8,7,12,58.3,5,14,1,13,4,22,3,0,Matches
1478,Arnau Martinez,es ESP,DF,Girona,es La Liga,20-284,2003,10.2,20,13,13,6,1,11,23,47.8,12,8,3,5,10,30,34,2,Matches
1479,Emiliano Martínez,ar ARG,GK,Aston Villa,eng Premier League,31-154,1992,21,0,0,0,0,0,0,0,,0,0,0,0,0,0,8,1,Matches
1480,Iñigo Martínez,es ESP,DF,Barcelona,es La Liga,32-262,1991,6,6,4,6,0,0,3,3,100,0,10,9,1,6,12,24,0,Matches
1481,Josep Martinez,es ESP,GK,Genoa,it Serie A,25-252,1998,21,0,0,0,0,0,0,0,,0,0,0,0,0,0,14,2,Matches
1482,Lautaro Martínez,ar ARG,FW,Inter,it Serie A,26-165,1997,17.7,19,14,3,12,4,3,11,27.3,8,14,1,13,16,35,7,0,Matches
1483,Lisandro Martínez,ar ARG,DF,Manchester Utd,eng Premier League,26-016,1998,5.4,9,6,8,1,0,5,12,41.7,7,6,4,2,4,13,15,0,Matches
1484,Lucas Martínez Quarta,ar ARG,DF,Fiorentina,it Serie A,27-269,1996,16.6,52,33,30,19,3,25,37,67.6,12,28,9,19,23,75,38,2,Matches
1485,Adam Marušić,me MNE,DF,Lazio,it Serie A,31-109,1992,19.5,29,20,14,14,1,18,31,58.1,13,15,4,11,21,50,38,2,Matches
1486,Marvin,es ESP,"FW,MF",Las Palmas,es La Liga,23-215,2000,8.6,16,9,6,8,2,7,18,38.9,11,11,2,9,6,22,9,0,Matches
1487,Omar Mascarell,es ESP,MF,Mallorca,es La Liga,31-001,1993,9,18,9,9,9,0,10,19,52.6,9,9,2,7,16,34,18,0,Matches
1488,Adam Masina,ma MAR,DF,Udinese,it Serie A,30-032,1994,0.7,4,0,2,2,0,2,4,50,2,2,1,1,2,6,5,0,Matches
1489,Erhan Mašović,rs SRB,DF,Bochum,de Bundesliga,25-073,1998,15.4,45,26,27,13,5,25,43,58.1,18,20,9,11,14,59,44,1,Matches
1490,Han-Noah Massengo,fr FRA,MF,Burnley,eng Premier League,22-211,2001,0.1,1,1,1,0,0,0,0,,0,1,0,1,0,1,0,0,Matches
1491,Roberto Massimo,de GER,"FW,DF",Stuttgart,de Bundesliga,23-114,2000,0.9,1,0,1,0,0,1,2,50,1,0,0,0,0,1,1,0,Matches
1492,Clinton Mata,ao ANG,DF,Lyon,fr Ligue 1,31-088,1992,13.7,20,13,14,4,2,10,21,47.6,11,16,7,9,22,42,23,0,Matches
1493,Jaime Mata,es ESP,"MF,FW",Getafe,es La Liga,35-102,1988,9.5,15,10,9,4,2,8,17,47.1,9,10,0,10,10,25,13,0,Matches
1494,Pape Matar Sarr,sn SEN,MF,Tottenham,eng Premier League,21-142,2002,13,22,17,7,11,4,11,21,52.4,10,12,4,8,12,34,18,0,Matches
1495,Eliot Matazo,be BEL,MF,Monaco,fr Ligue 1,21-353,2002,1.1,3,1,0,3,0,2,4,50,2,1,1,0,3,6,0,0,Matches
1496,Jean-Philippe Mateta,fr FRA,FW,Crystal Palace,eng Premier League,26-220,1997,11,10,7,3,4,3,3,5,60,2,6,1,5,2,12,6,0,Matches
1497,Nemanja Matić,rs SRB,MF,Rennes,fr Ligue 1,35-186,1988,11.4,19,10,7,9,3,9,12,75,3,15,7,8,27,46,19,0,Matches
1498,Joël Matip,cm CMR,DF,Liverpool,eng Premier League,32-179,1991,8.7,12,6,7,4,1,8,12,66.7,4,16,12,4,9,21,43,0,Matches
1499,Alex Matos,eng ENG,MF,Chelsea,eng Premier League,19-123,2004,0,0,0,0,0,0,0,0,,0,0,0,0,0,0,0,0,Matches
1500,Chrislain Matsima,fr FRA,DF,Monaco,fr Ligue 1,21-264,2002,3.3,9,7,5,3,1,2,7,28.6,5,4,1,3,4,13,4,0,Matches
1501,Remi Matthews,eng ENG,GK,Crystal Palace,eng Premier League,29-358,1994,0,0,0,0,0,0,0,0,,0,0,0,0,0,0,1,0,Matches
1502,Alan Matturro,uy URU,DF,Genoa,it Serie A,19-115,2004,1,1,1,1,0,0,1,1,100,0,4,1,3,2,3,3,0,Matches
1503,Azor Matusiwa,nl NED,MF,Reims,fr Ligue 1,25-281,1998,15.4,39,27,17,19,3,22,32,68.8,10,21,3,18,33,72,32,1,Matches
1504,Azor Matusiwa,nl NED,MF,Rennes,fr Ligue 1,25-281,1998,0.3,0,0,0,0,0,0,0,,0,0,0,0,0,0,0,0,Matches
1505,Neal Maupay,fr FRA,FW,Brentford,eng Premier League,27-173,1996,9.5,8,6,4,3,1,3,7,42.9,4,7,0,7,2,10,3,0,Matches
1506,Neal Maupay,fr FRA,FW,Everton,eng Premier League,27-173,1996,1.2,0,0,0,0,0,0,1,0,1,2,0,2,0,0,1,0,Matches
1507,Aïman Maurer,ma MAR,"MF,FW",Clermont Foot,fr Ligue 1,19-131,2004,0.6,1,1,1,0,0,1,3,33.3,2,0,0,0,0,1,0,0,Matches
1508,Konstantinos Mavropanos,gr GRE,DF,West Ham,eng Premier League,26-054,1997,7.5,10,6,8,2,0,5,6,83.3,1,11,5,6,13,23,40,1,Matches
1509,Christian Mawissa,fr FRA,DF,Toulouse,fr Ligue 1,18-291,2005,3.3,2,2,0,1,1,1,3,33.3,2,5,3,2,4,6,14,1,Matches
1510,Philipp Max,de GER,"DF,MF",Eint Frankfurt,de Bundesliga,30-126,1993,9.4,16,9,4,10,2,14,20,70,6,13,1,12,4,20,9,0,Matches
1511,Eric Maxim Choupo-Moting,cm CMR,"MF,FW",Bayern Munich,de Bundesliga,34-317,1989,3.8,9,7,3,4,2,2,3,66.7,1,1,0,1,2,11,3,0,Matches
1512,Luís Maximiano,pt POR,GK,Almería,es La Liga,25-029,1999,19,0,0,0,0,0,0,1,0,1,0,0,0,0,0,10,1,Matches
1513,Noam Mayoka-Tika,be BEL,MF,Marseille,fr Ligue 1,20-093,2003,0,0,0,0,0,0,0,0,,0,0,0,0,0,0,0,0,Matches
1514,Borja Mayoral,es ESP,FW,Getafe,es La Liga,26-304,1997,19.6,8,4,2,1,5,5,14,35.7,9,7,0,7,2,10,15,0,Matches
1515,Youssef Maziz,fr FRA,"FW,MF",Metz,fr Ligue 1,25-224,1998,1.4,0,0,0,0,0,0,2,0,2,1,0,1,1,1,2,0,Matches
1516,Noussair Mazraoui,ma MAR,DF,Bayern Munich,de Bundesliga,26-081,1997,9.1,12,8,5,5,2,5,10,50,5,9,1,8,13,25,16,1,Matches
1517,Luca Mazzitelli,it ITA,MF,Frosinone,it Serie A,28-080,1995,12.6,23,16,7,12,4,13,30,43.3,17,13,2,11,7,30,26,0,Matches
1518,Pasquale Mazzocchi,it ITA,DF,Salernitana,it Serie A,28-191,1995,14.1,25,19,14,10,1,16,29,55.2,13,14,6,8,5,30,31,0,Matches
1519,Pasquale Mazzocchi,it ITA,"DF,MF",Napoli,it Serie A,28-191,1995,0.2,1,1,0,1,0,1,1,100,0,0,0,0,0,1,0,0,Matches
1520,Kevin Mbabu,ch SUI,DF,Augsburg,de Bundesliga,28-290,1995,10.9,29,21,16,8,5,13,17,76.5,4,18,8,10,13,42,24,0,Matches
1521,Noah Mbamba,be BEL,MF,Leverkusen,de Bundesliga,19-029,2005,0.2,0,0,0,0,0,0,0,,0,0,0,0,1,1,0,0,Matches
1522,Ethan Mbappé,fr FRA,MF,Paris S-G,fr Ligue 1,17-036,2006,0,0,0,0,0,0,0,0,,0,0,0,0,0,0,0,0,Matches
1523,Kylian Mbappé,fr FRA,FW,Paris S-G,fr Ligue 1,25-045,1998,17.8,3,1,1,1,1,3,7,42.9,4,3,0,3,2,5,1,0,Matches
1524,Malick Mbaye,sn SEN,"MF,FW",Metz,fr Ligue 1,19-303,2004,1.7,5,1,0,1,4,1,2,50,1,1,0,1,1,6,2,0,Matches
1525,Mamadou Mbaye,sn SEN,DF,Cádiz,es La Liga,25-220,1998,3.2,6,3,3,3,0,2,5,40,3,10,7,3,5,11,26,0,Matches
1526,Chancel Mbemba,cd COD,DF,Marseille,fr Ligue 1,29-179,1994,16,21,15,18,2,1,12,18,66.7,6,13,9,4,11,32,64,0,Matches
1527,Nolan Mbemba,cg CGO,MF,Le Havre,fr Ligue 1,28-349,1995,0.2,2,1,0,1,1,1,2,50,1,0,0,0,0,2,0,0,Matches
1528,Bryan Mbeumo,cm CMR,FW,Brentford,eng Premier League,24-180,1999,14.3,12,8,6,4,2,4,13,30.8,9,14,0,14,5,17,9,0,Matches
1529,Jordi Mboula,es ESP,"FW,MF",Hellas Verona,it Serie A,24-324,1999,3.4,4,4,1,2,1,4,7,57.1,3,4,1,3,1,5,0,0,Matches
1530,Nathanael Mbuku,fr FRA,FW,Augsburg,de Bundesliga,21-324,2002,0.1,0,0,0,0,0,0,0,,0,1,0,1,0,0,0,0,Matches
1531,James Mcatee,eng ENG,MF,Sheffield Utd,eng Premier League,21-108,2002,13.2,26,16,6,11,9,11,22,50,11,15,0,15,7,33,10,0,Matches
1532,James Mcatee,eng ENG,MF,Manchester City,eng Premier League,21-108,2002,0,0,0,0,0,0,0,0,,0,1,0,1,0,0,0,0,Matches
1533,Oliver McBurnie,sct SCO,FW,Sheffield Utd,eng Premier League,27-244,1996,8.7,10,2,1,4,5,1,4,25,3,14,2,12,3,13,17,0,Matches
1534,James McConnell,eng ENG,MF,Liverpool,eng Premier League,19-143,2004,0,0,0,0,0,0,0,0,,0,1,0,1,1,1,0,0,Matches
1535,John McGinn,sct SCO,"MF,FW",Aston Villa,eng Premier League,29-108,1994,20.9,34,19,8,23,3,17,46,37,29,15,1,14,13,47,11,0,Matches
1536,Scott McKenna,sct SCO,DF,Nott'ham Forest,eng Premier League,27-083,1996,4.6,4,0,3,1,0,2,3,66.7,1,6,4,2,5,9,27,0,Matches
1537,Weston McKennie,us USA,"MF,FW",Juventus,it Serie A,25-159,1998,18.8,38,24,25,9,4,14,20,70,6,20,6,14,15,53,47,0,Matches
1538,Dwight McNeil,eng ENG,"MF,FW",Everton,eng Premier League,24-073,1999,16.5,25,13,11,8,6,13,30,43.3,17,31,4,27,12,37,21,0,Matches
1539,Scott McTominay,sct SCO,MF,Manchester Utd,eng Premier League,27-057,1996,12.9,32,15,15,16,1,13,22,59.1,9,20,7,13,10,42,32,0,Matches
1540,Facundo Medina,ar ARG,DF,Lens,fr Ligue 1,24-251,1999,16.2,38,24,13,21,4,27,42,64.3,15,29,9,20,13,51,28,1,Matches
1541,Ben Mee,eng ENG,DF,Brentford,eng Premier League,34-135,1989,9.5,17,12,8,7,2,11,15,73.3,4,14,9,5,9,26,37,1,Matches
1542,Marvin Mehlem,de GER,MF,Darmstadt 98,de Bundesliga,26-145,1997,10.8,18,13,6,8,4,8,20,40,12,16,2,14,24,42,13,0,Matches
1543,Abdoul Meité,fr FRA,MF,Marseille,fr Ligue 1,22-062,2001,2,,0,,,,,,,,,,,6,,,,Matches
1544,Bamo Meïté,ci CIV,DF,Marseille,fr Ligue 1,22-228,2001,1,1,0,0,1,0,0,1,0,1,3,1,2,1,2,15,0,Matches
1545,Bamo Meïté,ci CIV,DF,Lorient,fr Ligue 1,22-228,2001,1.6,2,1,2,0,0,0,1,0,1,3,2,1,3,5,9,0,Matches
1546,Hannibal Mejbri,tn TUN,"MF,FW",Manchester Utd,eng Premier League,21-013,2003,1.5,3,3,1,2,0,1,3,33.3,2,1,1,0,0,3,0,0,Matches
1547,Hannibal Mejbri,tn TUN,MF,Sevilla,es La Liga,21-013,2003,0.3,0,0,0,0,0,0,0,,0,0,0,0,0,0,0,0,Matches
1548,Óscar Melendo,es ESP,"MF,FW",Granada,es La Liga,26-164,1997,9.1,12,5,4,8,0,3,10,30,7,12,0,12,4,16,2,1,Matches
1549,Gonzalo Melero,es ESP,"MF,FW",Almería,es La Liga,30-032,1994,8.8,10,6,5,4,1,4,11,36.4,7,7,1,6,3,13,5,0,Matches
1550,Birger Meling,no NOR,DF,Rennes,fr Ligue 1,29-048,1994,0.2,1,1,1,0,0,1,1,100,0,1,0,1,0,1,0,0,Matches
1551,Arthur Melo,br BRA,MF,Fiorentina,it Serie A,27-175,1996,15.3,35,22,13,18,4,19,31,61.3,12,20,3,17,12,47,5,0,Matches
1552,Memphis,nl NED,FW,Atlético Madrid,es La Liga,29-355,1994,4.8,4,1,0,2,2,3,3,100,0,1,0,1,1,5,0,0,Matches
1553,Houboulang Mendes,gw GNB,DF,Almería,es La Liga,25-275,1998,4.4,16,13,11,5,0,8,16,50,8,4,2,2,1,17,17,1,Matches
1554,Tomás Mendes,es ESP,MF,Alavés,es La Liga,19-074,2004,0.1,0,0,0,0,0,0,0,,0,0,0,0,0,0,0,0,Matches
1555,Brais Méndez,es ESP,"MF,FW",Real Sociedad,es La Liga,27-027,1997,17.9,27,16,9,11,7,11,34,32.4,23,16,3,13,7,34,13,0,Matches
1556,Bruno Méndez,uy URU,DF,Granada,es La Liga,24-146,1999,3.9,6,2,4,1,1,3,5,60,2,5,3,2,4,10,14,0,Matches
1557,Diego Méndez,es ESP,MF,Rayo Vallecano,es La Liga,20-158,2003,0.1,1,1,1,0,0,1,1,100,0,0,0,0,1,2,0,0,Matches
1558,Antoine Mendy,fr FRA,DF,Nice,fr Ligue 1,19-252,2004,1,3,1,1,2,0,2,3,66.7,1,1,0,1,2,5,2,0,Matches
1559,Benjamin Mendy,fr FRA,"DF,FW",Lorient,fr Ligue 1,29-201,1994,4,1,0,1,0,0,0,3,0,3,6,1,5,4,5,8,0,Matches
1560,Ferland Mendy,fr FRA,DF,Real Madrid,es La Liga,28-240,1995,9.5,7,4,4,2,1,5,8,62.5,3,6,2,4,11,18,15,0,Matches
1561,Formose Mendy,sn SEN,DF,Lorient,fr Ligue 1,23-032,2001,8.5,17,10,13,4,0,13,23,56.5,10,15,6,9,14,31,37,0,Matches
1562,Nampalys Mendy,sn SEN,MF,Lens,fr Ligue 1,31-225,1992,2.7,8,3,4,2,2,4,5,80,1,5,2,3,4,12,3,0,Matches
1563,Teden Mengi,eng ENG,DF,Luton Town,eng Premier League,21-279,2002,13.6,27,9,16,10,1,10,16,62.5,6,16,10,6,31,58,59,0,Matches
1564,Chris Mepham,wls WAL,DF,Bournemouth,eng Premier League,26-090,1997,3,4,4,3,1,0,2,6,33.3,4,6,3,3,4,8,11,1,Matches
1565,Jorge Meré,es ESP,DF,Cádiz,es La Liga,26-292,1997,3.6,3,3,2,1,0,1,3,33.3,2,4,3,1,4,7,22,0,Matches
1566,Alex Meret,it ITA,GK,Napoli,it Serie A,26-318,1997,15.8,0,0,0,0,0,0,0,,0,0,0,0,0,0,7,0,Matches
1567,Mikel Merino,es ESP,MF,Real Sociedad,es La Liga,27-226,1996,15.2,33,19,11,14,8,12,25,48,13,21,6,15,8,41,35,3,Matches
1568,Quentin Merlin,fr FRA,DF,Nantes,fr Ligue 1,21-263,2002,14.3,29,20,15,12,2,16,25,64,9,22,1,21,18,47,22,0,Matches
1569,Junior Messias,br BRA,"DF,MF",Genoa,it Serie A,32-266,1991,4.8,15,12,10,4,1,8,12,66.7,4,2,0,2,2,17,9,0,Matches
1570,Thomas Meunier,be BEL,DF,Dortmund,de Bundesliga,32-144,1991,6.5,5,1,3,2,0,3,13,23.1,10,8,2,6,4,9,22,0,Matches
1571,Bastien Meupiyou,fr FRA,DF,Nantes,fr Ligue 1,17-321,2006,0.1,0,0,0,0,0,0,0,,0,0,0,0,0,0,1,0,Matches
1572,Alexander Meyer,de GER,GK,Dortmund,de Bundesliga,32-296,1991,2.7,1,1,1,0,0,1,1,100,0,0,0,0,0,1,1,0,Matches
1573,Omenuke Mfulu,cd COD,"MF,FW",Las Palmas,es La Liga,29-320,1994,0.9,4,3,3,1,0,0,1,0,1,1,1,0,2,6,5,0,Matches
1574,Sven Michel,de GER,"FW,MF",Augsburg,de Bundesliga,33-203,1990,5.1,5,3,1,1,3,2,6,33.3,4,1,0,1,0,5,4,0,Matches
1575,Miguel,es ESP,"FW,MF",Alavés,es La Liga,24-153,1999,0.7,0,0,0,0,0,0,0,,0,2,0,2,0,0,0,0,Matches
1576,Georges Mikautadze,ge GEO,FW,Metz,fr Ligue 1,23-095,2000,4.8,2,2,0,2,0,0,4,0,4,3,0,3,2,4,0,0,Matches
1577,Nikola Milenković,rs SRB,DF,Fiorentina,it Serie A,26-114,1997,16.1,31,15,17,13,1,17,26,65.4,9,15,9,6,11,42,56,1,Matches
1578,Lewis Miley,eng ENG,MF,Newcastle Utd,eng Premier League,17-278,2006,9.1,16,11,5,7,4,8,17,47.1,9,15,2,13,5,21,10,2,Matches
1579,Arkadiusz Milik,pl POL,FW,Juventus,it Serie A,29-340,1994,6.3,3,3,1,1,1,1,2,50,1,6,1,5,2,5,2,0,Matches
1580,Vanja Milinković-Savić,rs SRB,GK,Torino,it Serie A,26-348,1997,20,1,0,1,0,0,1,1,100,0,0,0,0,1,2,6,3,Matches
1581,Éder Militão,br BRA,DF,Real Madrid,es La Liga,26-016,1998,0.5,0,0,0,0,0,0,0,,0,1,0,1,0,0,1,0,Matches
1582,Luis Milla,es ESP,MF,Getafe,es La Liga,29-119,1994,9,18,15,6,8,4,7,13,53.8,6,7,1,6,12,30,2,0,Matches
1583,Enzo Millot,fr FRA,"MF,FW",Stuttgart,de Bundesliga,21-201,2002,14.3,24,13,5,11,8,10,22,45.5,12,13,1,12,8,32,5,1,Matches
1584,James Milner,eng ENG,"DF,MF",Brighton,eng Premier League,38-030,1986,8.6,20,14,9,10,1,9,14,64.3,5,9,0,9,8,28,16,0,Matches
1585,Jovan Milošević,rs SRB,"FW,MF",Stuttgart,de Bundesliga,18-187,2005,0.3,0,0,0,0,0,0,0,,0,0,0,0,0,0,0,0,Matches
1586,Marko Milovanović,rs SRB,FW,Almería,es La Liga,20-183,2003,2,2,2,0,2,0,1,2,50,1,1,0,1,0,2,4,0,Matches
1587,Kim Min-jae,kr KOR,DF,Bayern Munich,de Bundesliga,27-080,1996,14.6,16,9,9,4,3,7,16,43.8,9,19,9,10,31,47,47,1,Matches
1588,Yerry Mina,co COL,"DF,MF",Fiorentina,it Serie A,29-133,1994,0.5,1,1,1,0,0,1,2,50,1,0,0,0,0,1,2,0,Matches
1589,Takumi Minamino,jp JPN,MF,Monaco,fr Ligue 1,29-018,1995,12.2,20,12,3,10,7,10,31,32.3,21,12,0,12,6,26,6,0,Matches
1590,Lucas Mincarelli,fr FRA,"DF,MF",Montpellier,fr Ligue 1,20-029,2004,4.2,12,8,8,2,2,8,13,61.5,5,5,1,4,4,16,11,0,Matches
1591,Tyrone Mings,eng ENG,DF,Aston Villa,eng Premier League,30-327,1993,0.3,0,0,0,0,0,0,0,,0,0,0,0,1,1,1,0,Matches
1592,Óscar Mingueza,es ESP,"DF,MF",Celta Vigo,es La Liga,24-266,1999,19.3,36,22,26,6,4,23,56,41.1,33,25,4,21,9,45,29,1,Matches
1593,Ignasi Miquel,es ESP,DF,Granada,es La Liga,31-128,1992,21.5,28,18,25,3,0,13,24,54.2,11,15,8,7,26,54,83,3,Matches
1594,Rafa Mir,es ESP,"FW,MF",Sevilla,es La Liga,26-230,1997,4.3,2,2,1,1,0,1,2,50,1,2,0,2,1,3,1,0,Matches
1595,Ignacio Miramon,ar ARG,MF,Lille,fr Ligue 1,20-236,2003,0.4,1,0,0,1,0,0,1,0,1,1,0,1,0,1,0,0,Matches
1596,Aleksei Miranchuk,ru RUS,"MF,FW",Atalanta,it Serie A,28-109,1995,5.3,6,3,3,3,0,2,5,40,3,3,1,2,0,6,1,1,Matches
1597,Juan Miranda,es ESP,DF,Betis,es La Liga,24-015,2000,9.2,10,8,4,4,2,4,6,66.7,2,14,4,10,9,19,33,0,Matches
1598,Kevin Miranda,it ITA,DF,Sassuolo,it Serie A,20-330,2003,0.2,0,0,0,0,0,0,0,,0,0,0,0,0,0,1,0,Matches
1599,Antonio Mirante,it ITA,GK,Milan,it Serie A,40-210,1983,1,0,0,0,0,0,0,0,,0,0,0,0,0,0,0,0,Matches
1600,Fabio Miretti,it ITA,MF,Juventus,it Serie A,20-184,2003,8.1,8,7,2,5,1,4,16,25,12,6,1,5,5,13,4,0,Matches
1601,Filippo Missori,it ITA,DF,Sassuolo,it Serie A,19-316,2004,0.8,2,2,1,1,0,2,3,66.7,1,1,0,1,2,4,1,0,Matches
1602,Tyrick Mitchell,eng ENG,DF,Crystal Palace,eng Premier League,24-155,1999,20.1,58,31,46,6,6,22,33,66.7,11,27,7,20,17,75,75,0,Matches
1603,Kaoru Mitoma,jp JPN,FW,Brighton,eng Premier League,26-259,1997,14.7,10,4,2,5,3,5,19,26.3,14,12,1,11,4,14,5,0,Matches
1604,Aleksandar Mitrović,rs SRB,FW,Fulham,eng Premier League,29-140,1994,0.4,0,0,0,0,0,0,0,,0,0,0,0,0,0,0,0,Matches
1605,Stefan Mitrović,rs SRB,DF,Getafe,es La Liga,33-257,1990,7.8,9,3,7,2,0,4,8,50,4,3,2,1,6,15,26,0,Matches
1606,Maximilian Mittelstädt,de GER,DF,Stuttgart,de Bundesliga,26-322,1997,10.3,41,25,24,13,4,25,37,67.6,12,19,3,16,25,66,20,0,Matches
1607,Henrikh Mkhitaryan,am ARM,MF,Inter,it Serie A,35-013,1989,18.8,44,24,11,26,7,16,31,51.6,15,9,1,8,22,66,27,0,Matches
1608,Jakub Moder,pl POL,"MF,DF",Brighton,eng Premier League,24-302,1999,1,7,5,2,2,3,4,6,66.7,2,1,0,1,0,7,4,0,Matches
1609,Luka Modrić,hr CRO,MF,Real Madrid,es La Liga,38-147,1985,10,12,6,7,2,3,4,9,44.4,5,8,3,5,9,21,6,0,Matches
1610,Terem Moffi,ng NGA,FW,Nice,fr Ligue 1,24-254,1999,13.1,3,3,0,2,1,1,7,14.3,6,6,0,6,2,5,11,0,Matches
1611,Mostafa Mohamed,eg EGY,FW,Nantes,fr Ligue 1,26-067,1997,11.5,9,7,2,6,1,2,12,16.7,10,13,2,11,7,16,9,0,Matches
1612,Kudus Mohammed,gh GHA,"FW,MF",West Ham,eng Premier League,23-185,2000,11.7,34,27,10,18,6,14,19,73.7,5,16,0,16,4,38,5,1,Matches
1613,Dion Moise Sahi,ci CIV,"MF,FW",Strasbourg,fr Ligue 1,22-045,2001,5.5,4,4,1,2,1,0,2,0,2,10,1,9,1,5,6,0,Matches
1614,Johan Mojica,co COL,"DF,FW",Osasuna,es La Liga,31-166,1992,11,18,14,5,9,4,7,10,70,3,9,0,9,15,33,16,0,Matches
1615,Alberto Moleiro,es ESP,"FW,MF",Las Palmas,es La Liga,20-126,2003,7.9,6,4,3,3,0,4,16,25,12,7,0,7,5,11,7,0,Matches
1616,Nahuel Molina,ar ARG,DF,Atlético Madrid,es La Liga,25-303,1998,12.7,25,16,8,15,2,15,32,46.9,17,9,1,8,5,30,23,1,Matches
1617,Florent Mollet,fr FRA,"MF,FW",Nantes,fr Ligue 1,32-076,1991,14.6,11,7,4,3,4,6,21,28.6,15,9,0,9,7,18,7,0,Matches
1618,Jon Moncayola,es ESP,MF,Osasuna,es La Liga,25-266,1998,10.2,13,8,9,4,0,6,14,42.9,8,13,3,10,10,23,14,0,Matches
1619,Ilario Monterisi,it ITA,DF,Frosinone,it Serie A,22-046,2001,14.6,21,12,12,7,2,11,25,44,14,21,17,4,7,28,58,0,Matches
1620,César Montes,mx MEX,DF,Almería,es La Liga,26-344,1997,11.6,15,9,7,8,0,6,10,60,4,14,4,10,7,22,50,0,Matches
1621,Gonzalo Montiel,ar ARG,DF,Nott'ham Forest,eng Premier League,27-033,1997,5.4,14,11,8,5,1,10,17,58.8,7,4,2,2,6,20,28,1,Matches
1622,Lorenzo Montipò,it ITA,GK,Hellas Verona,it Serie A,27-348,1996,22,0,0,0,0,0,0,2,0,2,0,0,0,0,0,16,1,Matches
1623,Kieffer Moore,wls WAL,"FW,MF",Bournemouth,eng Premier League,31-179,1992,1.2,0,0,0,0,0,0,0,,0,0,0,0,0,0,0,0,Matches
1624,Álvaro Morata,es ESP,FW,Atlético Madrid,es La Liga,31-103,1992,15.1,8,4,1,3,4,2,2,100,0,14,3,11,0,8,22,0,Matches
1625,Diego Moreira,pt POR,"FW,MF",Lyon,fr Ligue 1,19-181,2004,3,0,0,0,0,0,0,3,0,3,3,0,3,2,2,5,0,Matches
1626,Alberto Moreno,es ESP,"DF,MF",Villarreal,es La Liga,31-213,1992,8.7,17,12,12,4,1,4,16,25,12,5,1,4,7,24,16,0,Matches
1627,Álex Moreno,es ESP,DF,Aston Villa,eng Premier League,30-240,1993,5,7,4,7,0,0,3,5,60,2,4,1,3,4,11,20,0,Matches
1628,Gerard Moreno,es ESP,FW,Villarreal,es La Liga,31-302,1992,16.3,22,10,9,6,7,9,19,47.4,10,16,6,10,6,28,15,0,Matches
1629,Manu Morlanes,es ESP,MF,Mallorca,es La Liga,25-022,1999,10,25,15,12,12,1,10,25,40,15,8,1,7,7,32,12,0,Matches
1630,Nikola Moro,hr CRO,MF,Bologna,it Serie A,25-328,1998,7.5,16,12,7,9,0,6,12,50,6,11,1,10,5,21,7,0,Matches
1631,Carlton Morris,eng ENG,FW,Luton Town,eng Premier League,28-049,1995,15,7,4,2,2,3,3,8,37.5,5,12,1,11,1,8,19,0,Matches
1632,Cristhian Mosquera,co COL,DF,Valencia,es La Liga,19-221,2004,18.2,31,19,18,11,2,15,25,60,10,19,7,12,20,51,75,2,Matches
1633,Yerson Mosquera,co COL,DF,Villarreal,es La Liga,22-277,2001,0.1,1,0,1,0,0,0,0,,0,1,0,1,0,1,0,0,Matches
1634,Dany Mota,pt POR,"FW,MF",Monza,it Serie A,25-277,1998,14.1,7,3,2,1,4,4,7,57.1,3,2,0,2,0,7,13,0,Matches
1635,Lebo Mothiba,za RSA,FW,Strasbourg,fr Ligue 1,28-006,1996,6.9,5,2,1,4,0,3,4,75,1,6,1,5,0,5,11,0,Matches
1636,Youssoufa Moukoko,de GER,FW,Dortmund,de Bundesliga,19-075,2004,3.5,3,0,2,1,0,2,4,50,2,4,1,3,1,4,1,0,Matches
1637,Steve Mounié,bj BEN,FW,Brest,fr Ligue 1,29-127,1994,10.4,6,5,0,2,4,2,8,25,6,9,2,7,1,7,9,0,Matches
1638,Mason Mount,eng ENG,MF,Manchester Utd,eng Premier League,25-024,1999,4.4,16,10,4,7,5,3,12,25,9,5,1,4,3,19,1,0,Matches
1639,Samuel Moutoussamy,cd COD,"MF,FW",Nantes,fr Ligue 1,27-175,1996,7.5,17,10,6,7,4,10,17,58.8,7,13,3,10,8,25,8,0,Matches
1640,Loris Mouyokolo,fr FRA,DF,Lorient,fr Ligue 1,22-257,2001,1,4,1,4,0,0,1,1,100,0,1,0,1,0,4,3,0,Matches
1641,Divin Mubama,eng ENG,FW,West Ham,eng Premier League,19-101,2004,0.9,0,0,0,0,0,0,0,,0,0,0,0,0,0,0,0,Matches
1642,Mykhailo Mudryk,ua UKR,FW,Chelsea,eng Premier League,23-029,2001,9.5,16,9,7,4,5,6,21,28.6,15,10,1,9,4,20,5,0,Matches
1643,François Mughe,cm CMR,"MF,DF",Marseille,fr Ligue 1,19-232,2004,2,0,0,0,0,0,0,3,0,3,2,0,2,1,1,1,0,Matches
1644,Joel Mugisha,no NOR,"DF,FW",Lorient,fr Ligue 1,21-083,2002,2,5,3,3,1,1,3,7,42.9,4,1,0,1,2,7,1,0,Matches
1645,Nordi Mukiele,fr FRA,DF,Paris S-G,fr Ligue 1,26-094,1997,4.2,8,5,4,4,0,6,11,54.5,5,6,2,4,7,15,20,0,Matches
1646,Samuele Mulattieri,it ITA,FW,Sassuolo,it Serie A,23-119,2000,2.3,1,1,0,0,1,1,1,100,0,7,2,5,0,1,1,0,Matches
1647,Andreas Müller,de GER,MF,Darmstadt 98,de Bundesliga,23-198,2000,1.1,6,6,2,3,1,3,3,100,0,1,1,0,1,7,3,0,Matches
1648,Jannik Müller,de GER,DF,Darmstadt 98,de Bundesliga,30-016,1994,6.7,11,4,9,2,0,6,9,66.7,3,9,6,3,9,20,25,0,Matches
1649,Kevin Müller,de GER,GK,Heidenheim,de Bundesliga,32-325,1991,20,1,0,1,0,0,1,1,100,0,0,0,0,0,1,5,1,Matches
1650,Marcus Müller,de GER,MF,Mainz 05,de Bundesliga,21-167,2002,0.2,0,0,0,0,0,0,0,,0,0,0,0,0,0,0,0,Matches
1651,Thomas Müller,de GER,"MF,FW",Bayern Munich,de Bundesliga,34-143,1989,6.8,11,8,1,4,6,7,16,43.8,9,14,0,14,0,11,2,0,Matches
1652,Abdul Mumin,gh GHA,DF,Rayo Vallecano,es La Liga,25-242,1998,8.8,10,5,7,2,1,4,6,66.7,2,15,11,4,9,19,50,0,Matches
1653,Marshall Munetsi,zw ZIM,MF,Reims,fr Ligue 1,27-226,1996,10.6,27,17,7,17,3,16,29,55.2,13,10,3,7,3,30,11,0,Matches
1654,Iker Muniain,es ESP,"MF,FW",Athletic Club,es La Liga,31-046,1992,3.9,4,0,1,3,0,1,1,100,0,3,0,3,0,4,0,0,Matches
1655,Rodrigo Muniz,br BRA,FW,Fulham,eng Premier League,22-275,2001,4.1,0,0,0,0,0,0,2,0,2,5,1,4,2,2,5,0,Matches
1656,Aihen Muñoz,es ESP,DF,Real Sociedad,es La Liga,26-171,1997,12.5,36,21,20,10,6,24,35,68.6,11,16,8,8,9,45,33,0,Matches
1657,Iker Muñoz,es ESP,MF,Osasuna,es La Liga,21-090,2002,9.8,13,10,5,8,0,7,15,46.7,8,5,1,4,5,18,25,0,Matches
1658,Javier Muñoz,es ESP,MF,Las Palmas,es La Liga,28-340,1995,17.7,26,12,9,12,5,11,29,37.9,18,24,3,21,14,40,15,0,Matches
1659,Luis Muriel,co COL,"FW,MF",Atalanta,it Serie A,32-293,1991,4.4,3,2,0,2,1,1,1,100,0,4,0,4,1,4,0,0,Matches
1660,Murillo,br BRA,DF,Nott'ham Forest,eng Premier League,21-214,2002,15.7,25,16,19,5,1,8,16,50,8,26,14,12,18,43,102,0,Matches
1661,Vedat Muriqi,xk KVX,FW,Mallorca,es La Liga,29-285,1994,12.7,5,3,3,0,2,2,8,25,6,2,1,1,1,6,14,0,Matches
1662,Alex Murphy,ie IRL,"FW,DF",Newcastle Utd,eng Premier League,19-223,2004,0,0,0,0,0,0,0,1,0,1,0,0,0,1,1,0,0,Matches
1663,Jacob Murphy,eng ENG,"FW,MF",Newcastle Utd,eng Premier League,28-344,1995,2.3,3,2,1,1,1,1,1,100,0,3,0,3,0,3,5,0,Matches
1664,Yunus Musah,us USA,"MF,FW",Milan,it Serie A,21-066,2002,10.4,15,7,9,3,3,3,8,37.5,5,12,4,8,8,23,10,1,Matches
1665,Jamal Musiala,de GER,"MF,FW",Bayern Munich,de Bundesliga,20-342,2003,11,30,20,6,16,8,13,24,54.2,11,18,1,17,8,38,2,0,Matches
1666,Florent Muslija,xk KVX,MF,Freiburg,de Bundesliga,25-212,1998,0.1,0,0,0,0,0,0,0,,0,0,0,0,0,0,0,0,Matches
1667,Juan Musso,ar ARG,GK,Atalanta,it Serie A,29-273,1994,10,1,0,1,0,0,1,1,100,0,0,0,0,0,1,6,0,Matches
1668,Yvon Mvogo,ch SUI,GK,Lorient,fr Ligue 1,29-242,1994,19,0,0,0,0,0,0,0,,0,0,0,0,0,0,9,1,Matches
1669,Joel Mvuka,no NOR,MF,Lorient,fr Ligue 1,21-073,2002,0.2,,0,,,,,,,,,,,0,,,,Matches
1670,Junior Mwanga,fr FRA,MF,Strasbourg,fr Ligue 1,20-268,2003,11.5,27,13,14,8,5,8,17,47.1,9,15,5,10,14,41,11,0,Matches
1671,Phillipp Mwene,at AUT,DF,Mainz 05,de Bundesliga,30-005,1994,10.3,17,7,7,8,2,8,14,57.1,6,14,0,14,11,28,19,0,Matches
1672,Vitaliy Mykolenko,ua UKR,DF,Everton,eng Premier League,24-250,1999,17,54,32,36,17,1,30,46,65.2,16,23,8,15,29,83,61,0,Matches
1673,Joakim Mæhle,dk DEN,DF,Wolfsburg,de Bundesliga,26-259,1997,16.9,37,22,21,10,6,25,40,62.5,15,27,4,23,19,56,48,0,Matches
1674,Obite N'Dicka,ci CIV,DF,Roma,it Serie A,24-167,1999,14.8,22,12,6,15,1,10,15,66.7,5,16,6,10,9,31,44,0,Matches
1675,Kévin N'Doram,fr FRA,MF,Metz,fr Ligue 1,28-012,1996,10.3,13,9,7,5,1,8,17,47.1,9,8,3,5,16,29,28,0,Matches
1676,Joseph N'Duquidi,fr FRA,"MF,DF",Metz,fr Ligue 1,19-095,2004,6.2,8,2,4,3,1,1,7,14.3,6,10,3,7,10,18,14,1,Matches
1677,Nathan N'Goumou,fr FRA,"FW,MF",M'Gladbach,de Bundesliga,23-326,2000,8,18,14,9,8,1,8,19,42.1,11,12,0,12,2,20,10,1,Matches
1678,Stanley N'Soki,fr FRA,DF,Hoffenheim,de Bundesliga,24-300,1999,3.3,13,7,8,4,1,10,17,58.8,7,4,1,3,4,17,16,0,Matches
1679,Nacho,es ESP,DF,Real Madrid,es La Liga,34-016,1990,9,11,7,4,5,2,4,9,44.4,5,13,7,6,9,20,20,0,Matches
1680,Bilal Nadir,fr FRA,"MF,FW",Marseille,fr Ligue 1,20-067,2003,1.3,4,3,2,2,0,1,2,50,1,0,0,0,2,6,2,0,Matches
1681,Mahamadou Nagida,cm CMR,DF,Rennes,fr Ligue 1,18-220,2005,1.2,1,1,0,0,1,0,2,0,2,2,1,1,4,5,0,0,Matches
1682,Marvelous Nakamba,zw ZIM,MF,Luton Town,eng Premier League,30-015,1994,12.6,40,24,24,14,2,24,42,57.1,18,23,6,17,11,51,11,1,Matches
1683,Keito Nakamura,jp JPN,FW,Reims,fr Ligue 1,23-190,2000,7.4,17,8,7,5,5,12,25,48,13,11,2,9,3,20,3,0,Matches
1684,Nahitan Nández,uy URU,"MF,DF",Cagliari,it Serie A,28-037,1995,13.5,19,13,8,7,4,7,26,26.9,19,10,1,9,6,25,19,0,Matches
1685,Matija Nastasić,rs SRB,DF,Mallorca,es La Liga,30-312,1993,15.1,19,8,13,6,0,11,15,73.3,4,25,15,10,14,33,65,0,Matches
1686,Natan,br BRA,DF,Napoli,it Serie A,22-362,2001,9.3,13,10,9,3,1,5,10,50,5,11,9,2,7,20,30,0,Matches
1687,Roberto Navarro,es ESP,MF,Cádiz,es La Liga,21-297,2002,6.9,19,12,4,11,4,7,17,41.2,10,10,0,10,9,28,5,0,Matches
1688,Jesús Navas,es ESP,DF,Sevilla,es La Liga,38-074,1985,11.5,27,19,13,12,2,20,30,66.7,10,7,4,3,14,41,18,0,Matches
1689,Michel Ndary Adopo,fr FRA,"MF,DF",Atalanta,it Serie A,23-199,2000,0.6,0,0,0,0,0,0,0,,0,0,0,0,0,0,2,1,Matches
1690,Youssouf Ndayishimiye,bi BDI,MF,Nice,fr Ligue 1,25-099,1998,15.2,18,11,9,9,0,7,15,46.7,8,16,9,7,9,27,38,1,Matches
1691,Bassirou Ndiaye,sn SEN,FW,Lorient,fr Ligue 1,21-353,2002,1.7,,2,,,,,,,,,,,1,,,,Matches
1692,Iliman Ndiaye,sn SEN,"FW,MF",Marseille,fr Ligue 1,23-334,2000,9.7,7,7,0,4,3,2,10,20,8,8,2,6,4,11,4,0,Matches
1693,Massamba Ndiaye,sn SEN,GK,Clermont Foot,fr Ligue 1,22-118,2001,2,0,0,0,0,0,0,0,,0,0,0,0,0,0,0,0,Matches
1694,Rassoul Ndiaye,fr FRA,"MF,FW",Le Havre,fr Ligue 1,22-054,2001,4.6,22,14,8,13,1,9,17,52.9,8,1,1,0,3,25,5,0,Matches
1695,Michael Ndiweni,eng ENG,FW,Newcastle Utd,eng Premier League,20-063,2003,0,0,0,0,0,0,0,0,,0,0,0,0,0,0,0,0,Matches
1696,Cher Ndour,it ITA,MF,Paris S-G,fr Ligue 1,19-191,2004,0.3,2,2,0,2,0,1,2,50,1,0,0,0,0,2,0,0,Matches
1697,Dan Ndoye,ch SUI,FW,Bologna,it Serie A,23-101,2000,11.4,22,11,14,8,0,12,25,48,13,9,1,8,5,27,10,0,Matches
1698,Joseph Nduquidi,fr FRA,MF,Metz,fr Ligue 1,19-101,2004,0.9,,0,,,,,,,,,,,0,,,,Matches
1699,Loïc Nego,hu HUN,"DF,MF",Le Havre,fr Ligue 1,33-019,1991,10.9,21,13,11,7,3,8,18,44.4,10,9,1,8,13,34,7,0,Matches
1700,Álvaro Negredo,es ESP,"FW,MF",Cádiz,es La Liga,38-167,1985,0.6,0,0,0,0,0,0,0,,0,1,0,1,1,1,0,0,Matches
1701,Reiss Nelson,eng ENG,"FW,MF",Arsenal,eng Premier League,24-055,1999,1.2,4,3,1,1,2,4,5,80,1,1,1,0,0,4,4,0,Matches
1702,Neto,br BRA,GK,Bournemouth,eng Premier League,34-199,1989,19,0,0,0,0,0,0,0,,0,1,0,1,1,1,8,1,Matches
1703,Pedro Neto,pt POR,"MF,FW",Wolves,eng Premier League,23-331,2000,11.9,6,3,2,2,2,5,13,38.5,8,4,1,3,3,9,2,0,Matches
1704,Luca Netz,de GER,DF,M'Gladbach,de Bundesliga,20-264,2003,15.2,30,19,15,12,3,16,31,51.6,15,25,8,17,13,43,61,1,Matches
1705,Manuel Neuer,de GER,GK,Bayern Munich,de Bundesliga,37-313,1986,11,0,0,0,0,0,0,0,,0,0,0,0,0,0,4,0,Matches
1706,Florian Neuhaus,de GER,MF,M'Gladbach,de Bundesliga,26-324,1997,7.8,11,9,6,5,0,6,19,31.6,13,5,4,1,11,22,7,0,Matches
1707,Carlos Neva,es ESP,DF,Granada,es La Liga,27-236,1996,21,23,15,16,6,1,13,29,44.8,16,26,10,16,9,32,67,1,Matches
1708,Jessic Ngankam,de GER,FW,Eint Frankfurt,de Bundesliga,23-198,2000,3.1,3,2,1,1,1,0,0,,0,0,0,0,0,3,1,0,Matches
1709,Cyril Ngonge,be BEL,"FW,MF",Hellas Verona,it Serie A,23-253,2000,15.9,14,9,5,3,6,5,14,35.7,9,7,1,6,4,18,10,0,Matches
1710,Cyril Ngonge,be BEL,FW,Napoli,it Serie A,23-253,2000,0.1,1,1,0,1,0,1,1,100,0,0,0,0,0,1,1,0,Matches
1711,Steve Ngoura,fr FRA,FW,Le Havre,fr Ligue 1,18-346,2005,0.5,1,1,0,1,0,0,1,0,1,0,0,0,0,1,0,0,Matches
1712,Moussa Niakhate,sn SEN,DF,Nott'ham Forest,eng Premier League,27-332,1996,10.9,27,19,22,5,0,10,13,76.9,3,14,8,6,9,36,38,0,Matches
1713,Tanguy Nianzou,fr FRA,DF,Sevilla,es La Liga,21-241,2002,2.3,12,8,9,2,1,8,10,80,2,1,0,1,2,14,6,0,Matches
1714,Shamar Nicholson,jm JAM,FW,Clermont Foot,fr Ligue 1,26-324,1997,10.8,4,1,0,3,1,0,3,0,3,5,1,4,0,4,12,0,Matches
1715,Rasmus Nicolaisen,dk DEN,DF,Toulouse,fr Ligue 1,26-324,1997,19,27,17,23,4,0,14,23,60.9,9,29,20,9,20,47,103,0,Matches
1716,Moritz Nicolas,de GER,GK,M'Gladbach,de Bundesliga,26-105,1997,17,1,0,1,0,0,1,2,50,1,0,0,0,0,1,6,1,Matches
1717,Hans Nicolussi Caviglia,it ITA,MF,Juventus,it Serie A,23-230,2000,2.5,3,0,1,2,0,3,5,60,2,4,0,4,0,3,2,0,Matches
1718,Saúl Ñíguez,es ESP,MF,Atlético Madrid,es La Liga,29-074,1994,10.8,47,28,21,21,5,22,37,59.5,15,27,7,20,11,58,38,0,Matches
1719,Rasmus Nissen,dk DEN,DF,Roma,it Serie A,26-207,1997,14.1,28,13,18,7,3,20,36,55.6,16,21,5,16,4,32,35,0,Matches
1720,Justin Njinmah,de GER,"FW,MF",Werder Bremen,de Bundesliga,23-080,2000,6.7,4,1,2,2,0,3,7,42.9,4,4,0,4,2,6,4,0,Matches
1721,Eddie Nketiah,eng ENG,FW,Arsenal,eng Premier League,24-249,1999,11,10,5,2,5,3,1,5,20,4,11,0,11,4,14,3,0,Matches
1722,Niels Nkounkou,fr FRA,"DF,MF",Eint Frankfurt,de Bundesliga,23-094,2000,7.6,25,13,16,9,0,13,29,44.8,16,21,1,20,10,35,19,0,Matches
1723,Christopher Nkunku,fr FRA,"MF,FW",Chelsea,eng Premier League,26-081,1997,2,0,0,0,0,0,0,0,,0,1,0,1,0,0,2,0,Matches
1724,Felix Nmecha,de GER,MF,Dortmund,de Bundesliga,23-116,2000,6.7,13,9,3,6,4,8,13,61.5,5,9,0,9,8,21,11,0,Matches
1725,Peru Nolaskoain,es ESP,"DF,MF",Athletic Club,es La Liga,25-101,1998,0.1,1,1,1,0,0,1,1,100,0,0,0,0,0,1,1,0,Matches
1726,Joseph Nonge,be BEL,MF,Juventus,it Serie A,18-264,2005,0.1,0,0,0,0,0,0,0,,0,0,0,0,0,0,0,0,Matches
1727,Arnaud Nordin,fr FRA,"FW,MF",Montpellier,fr Ligue 1,25-231,1998,4.1,3,1,1,2,0,1,4,25,3,3,0,3,1,4,3,0,Matches
1728,Rhys Norrington-Davies,wls WAL,DF,Sheffield Utd,eng Premier League,24-287,1999,0.6,1,1,1,0,0,0,0,,0,0,0,0,1,2,2,0,Matches
1729,Oliver Norwood,nir NIR,MF,Sheffield Utd,eng Premier League,32-297,1991,14.2,35,21,14,17,4,17,39,43.6,22,19,6,13,18,53,38,0,Matches
1730,Tijjani Noslin,nl NED,FW,Hellas Verona,it Serie A,24-211,1999,0.9,0,0,0,0,0,0,0,,0,0,0,0,0,0,0,0,Matches
1731,Randy Ntekja,fr FRA,"FW,MF",Rayo Vallecano,es La Liga,26-059,1997,5.1,7,1,1,3,3,3,7,42.9,4,5,1,4,2,9,8,0,Matches
1732,Ernest Nuamah,gh GHA,"FW,MF",Lyon,fr Ligue 1,20-094,2003,10.9,17,8,8,5,4,7,18,38.9,11,4,1,3,4,21,5,0,Matches
1733,Alexander Nübel,de GER,GK,Stuttgart,de Bundesliga,27-126,1996,19,1,1,1,0,0,1,2,50,1,0,0,0,0,1,6,1,Matches
1734,Matheus Nunes,pt POR,MF,Wolves,eng Premier League,25-160,1998,2,3,1,3,0,0,2,6,33.3,4,0,0,0,6,9,1,0,Matches
1735,Matheus Nunes,pt POR,MF,Manchester City,eng Premier League,25-160,1998,4.3,7,3,1,5,1,3,9,33.3,6,2,1,1,0,7,6,0,Matches
1736,Darwin Núñez,uy URU,FW,Liverpool,eng Premier League,24-224,1999,14.4,16,11,2,9,5,8,17,47.1,9,15,5,10,1,17,4,0,Matches
1737,Unai Núñez,es ESP,DF,Celta Vigo,es La Liga,27-004,1997,22,29,16,12,15,2,11,26,42.3,15,27,18,9,39,68,108,0,Matches
1738,Fabian Nürnberger,de GER,"DF,MF",Darmstadt 98,de Bundesliga,24-190,1999,12.4,19,14,16,3,0,17,33,51.5,16,6,1,5,12,31,20,0,Matches
1739,Simeon Nwankwo,ng NGA,FW,Salernitana,it Serie A,31-272,1992,5.3,2,0,0,0,2,0,2,0,2,4,0,4,0,2,3,0,Matches
1740,Gerzino Nyamsi,fr FRA,DF,Strasbourg,fr Ligue 1,27-012,1997,12.1,18,14,13,5,0,12,18,66.7,6,19,11,8,10,28,43,0,Matches
1741,Ørjan Nyland,no NOR,GK,Sevilla,es La Liga,33-146,1990,8,0,0,0,0,0,0,0,,0,0,0,0,0,0,2,0,Matches
1742,M'Bala Nzola,ao ANG,FW,Fiorentina,it Serie A,27-169,1996,13.7,8,6,0,3,5,4,5,80,1,7,0,7,0,8,18,0,Matches
1743,Christian Nørgaard,dk DEN,MF,Brentford,eng Premier League,29-330,1994,18.2,56,36,28,22,6,22,57,38.6,35,31,2,29,28,84,39,0,Matches
1744,Jake O'Brien,ie IRL,DF,Lyon,fr Ligue 1,,,12.3,4,4,4,0,0,2,6,33.3,4,10,8,2,5,9,44,1,Matches
1745,Dara O'Shea,ie IRL,DF,Burnley,eng Premier League,24-336,1999,17.4,18,10,12,4,2,6,11,54.5,5,25,18,7,19,37,85,1,Matches
1746,Michael Obafemi,ie IRL,"FW,MF",Burnley,eng Premier League,23-212,2000,0.2,0,0,0,0,0,0,0,,0,1,0,1,0,0,0,0,Matches
1747,Adam Obert,sk SVK,DF,Cagliari,it Serie A,21-164,2002,4.7,10,5,4,5,1,5,8,62.5,3,10,5,5,9,19,18,0,Matches
1748,Pedro Obiang,gq EQG,MF,Sassuolo,it Serie A,31-313,1992,0.1,0,0,0,0,0,0,0,,0,0,0,0,0,0,0,0,Matches
1749,Jan Oblak,si SVN,GK,Atlético Madrid,es La Liga,31-027,1993,22,0,0,0,0,0,0,0,,0,0,0,0,0,0,4,0,Matches
1750,Brian Ocampo,uy URU,MF,Cádiz,es La Liga,24-223,1999,1.4,2,1,0,2,0,1,2,50,1,3,0,3,0,2,0,0,Matches
1751,Lucas Ocampos,ar ARG,FW,Sevilla,es La Liga,29-207,1994,19,31,21,8,12,11,11,22,50,11,19,0,19,9,40,11,0,Matches
1752,Guillermo Ochoa,mx MEX,GK,Salernitana,it Serie A,38-205,1985,14,0,0,0,0,0,0,0,,0,0,0,0,0,0,8,0,Matches
1753,Wilson Odobert,fr FRA,"MF,FW",Burnley,eng Premier League,19-067,2004,8.1,12,9,5,4,3,6,15,40,9,14,1,13,3,15,6,0,Matches
1754,Álvaro Odriozola,es ESP,DF,Real Sociedad,es La Liga,28-051,1995,1.2,1,0,0,1,0,0,0,,0,1,1,0,4,5,1,0,Matches
1755,Tim Oermann,de GER,DF,Bochum,de Bundesliga,20-120,2003,3,6,4,2,2,2,2,3,66.7,1,5,3,2,1,7,6,0,Matches
1756,Chiedozie Ogbene,ie IRL,"MF,DF",Luton Town,eng Premier League,26-278,1997,13.3,15,9,9,6,0,10,17,58.8,7,8,1,7,4,19,18,1,Matches
1757,Angelo Ogbonna,it ITA,DF,West Ham,eng Premier League,35-256,1988,3.6,3,1,3,0,0,2,2,100,0,10,8,2,2,5,18,0,Matches
1758,Florent Ogier,fr FRA,DF,Clermont Foot,fr Ligue 1,34-319,1989,7.4,11,4,7,4,0,5,9,55.6,4,18,13,5,8,19,25,3,Matches
1759,Noah Okafor,ch SUI,FW,Milan,it Serie A,23-255,2000,4.7,1,0,0,1,0,0,3,0,3,1,0,1,0,1,6,0,Matches
1760,Caleb Okoli,it ITA,DF,Frosinone,it Serie A,22-205,2001,16.6,26,14,10,16,0,12,21,57.1,9,29,23,6,10,36,74,3,Matches
1761,Maduka Okoye,ng NGA,GK,Udinese,it Serie A,24-159,1999,5,0,0,0,0,0,0,0,,0,0,0,0,1,1,0,0,Matches
1762,Masaya Okugawa,jp JPN,"FW,DF",Augsburg,de Bundesliga,27-295,1996,0.4,0,0,0,0,0,0,0,,0,0,0,0,0,0,2,0,Matches
1763,Joseph Okumu,ke KEN,DF,Reims,fr Ligue 1,26-253,1997,14.3,32,20,21,9,2,15,27,55.6,12,9,5,4,26,58,93,2,Matches
1764,Michael Olakigbe,eng ENG,"DF,FW",Brentford,eng Premier League,19-284,2004,0.7,3,0,2,1,0,2,4,50,2,7,0,7,1,4,0,1,Matches
1765,Olasagasti,es ESP,MF,Real Sociedad,es La Liga,23-171,2000,1.4,7,5,2,4,1,3,5,60,2,1,0,1,2,9,3,0,Matches
1766,Finn Ole Becker,de GER,MF,Hoffenheim,de Bundesliga,23-240,2000,4.5,8,7,6,2,0,3,14,21.4,11,9,1,8,0,8,5,0,Matches
1767,Mathias Olesen,lu LUX,"MF,FW",Köln,de Bundesliga,22-319,2001,1.2,0,0,0,0,0,0,0,,0,0,0,0,2,2,2,0,Matches
1768,Michael Olise,fr FRA,"FW,MF",Crystal Palace,eng Premier League,22-053,2001,8.3,14,8,5,8,1,8,20,40,12,14,0,14,6,20,8,0,Matches
1769,Mathías Olivera,uy URU,DF,Napoli,it Serie A,26-095,1997,8.3,28,16,19,7,2,13,22,59.1,9,13,1,12,8,36,14,0,Matches
1770,Dani Olmo,es ESP,"MF,FW",RB Leipzig,de Bundesliga,25-272,1998,5,6,3,2,2,2,3,7,42.9,4,1,0,1,6,12,3,0,Matches
1771,Robin Olsen,se SWE,GK,Aston Villa,eng Premier League,34-026,1990,1,0,0,0,0,0,0,0,,0,0,0,0,0,0,0,0,Matches
1772,Warmed Omari,fr FRA,DF,Rennes,fr Ligue 1,23-286,2000,13,20,14,13,5,2,10,19,52.6,9,23,16,7,23,43,46,2,Matches
1773,Becir Omeragic,ch SUI,DF,Montpellier,fr Ligue 1,22-014,2002,12.9,24,13,15,7,2,13,21,61.9,8,23,15,8,12,36,35,0,Matches
1774,Jonas Omlin,ch SUI,GK,M'Gladbach,de Bundesliga,30-024,1994,2,0,0,0,0,0,0,0,,0,0,0,0,0,0,1,0,Matches
1775,Andrew Omobamidele,ie IRL,DF,Nott'ham Forest,eng Premier League,21-225,2002,2,2,1,2,0,0,2,3,66.7,1,1,1,0,5,7,9,0,Matches
1776,Samuel Omorodion,es ESP,FW,Alavés,es La Liga,19-274,2004,11.8,3,1,0,3,0,0,2,0,2,5,1,4,1,4,6,0,Matches
1777,Samuel Omorodion,es ESP,FW,Granada,es La Liga,19-274,2004,0.9,1,1,0,1,0,1,1,100,0,0,0,0,0,1,0,0,Matches
1778,Amadou Onana,be BEL,MF,Everton,eng Premier League,22-171,2001,15.6,45,26,20,18,7,14,27,51.9,13,15,2,13,10,55,19,0,Matches
1779,André Onana,cm CMR,GK,Manchester Utd,eng Premier League,27-307,1996,22,1,0,1,0,0,1,1,100,0,0,0,0,0,1,3,1,Matches
1780,Jean Onana,cm CMR,MF,Marseille,fr Ligue 1,24-026,2000,1.1,5,3,3,1,1,4,8,50,4,0,0,0,4,9,1,0,Matches
1781,Ryan One,sct SCO,FW,Sheffield Utd,eng Premier League,17-222,2006,0.1,0,0,0,0,0,0,0,,0,0,0,0,0,0,0,0,Matches
1782,Karim Onisiwo,at AUT,"FW,MF",Mainz 05,de Bundesliga,31-323,1992,10.9,10,5,1,5,4,3,6,50,3,14,3,11,1,11,1,0,Matches
1783,Tyler Onyango,eng ENG,MF,Everton,eng Premier League,20-336,2003,0,0,0,0,0,0,0,0,,0,0,0,0,0,0,0,0,Matches
1784,Frank Onyeka,ng NGA,MF,Brentford,eng Premier League,26-033,1998,8.2,23,15,5,14,4,9,16,56.3,7,9,4,5,14,37,13,0,Matches
1785,Loïs Openda,be BEL,FW,RB Leipzig,de Bundesliga,23-352,2000,16.9,2,2,0,0,2,0,3,0,3,7,0,7,4,6,7,0,Matches
1786,Royce Openda Owaga,ga GAB,FW,Lorient,fr Ligue 1,21-288,2002,0.2,,0,,,,,,,,,,,0,,,,Matches
1787,Christopher Operi,fr FRA,DF,Le Havre,fr Ligue 1,26-280,1997,14.2,31,20,17,11,3,15,28,53.6,13,18,2,16,16,47,32,1,Matches
1788,Leon Opitz,de GER,"FW,DF",Werder Bremen,de Bundesliga,18-298,2005,0.2,2,2,1,1,0,2,3,66.7,1,0,0,0,0,2,0,0,Matches
1789,Gift Orban,ng NGA,MF,Lyon,fr Ligue 1,21-201,2002,0.5,0,0,0,0,0,0,0,,0,0,0,0,0,0,0,0,Matches
1790,Willi Orban,hu HUN,DF,RB Leipzig,de Bundesliga,31-092,1992,3.1,8,4,2,5,1,4,5,80,1,4,1,3,2,10,14,0,Matches
1791,Ivan Ordets,ua UKR,DF,Bochum,de Bundesliga,31-210,1992,9.7,6,3,2,3,1,3,6,50,3,19,13,6,21,27,60,0,Matches
1792,Divock Origi,be BEL,"FW,MF",Nott'ham Forest,eng Premier League,28-291,1995,2,0,0,0,0,0,0,0,,0,1,0,1,0,0,0,0,Matches
1793,Gaetano Oristanio,it ITA,"FW,MF",Cagliari,it Serie A,21-128,2002,9.4,14,8,4,9,1,3,11,27.3,8,5,0,5,7,21,7,0,Matches
1794,Aimar Oroz,es ESP,MF,Osasuna,es La Liga,22-068,2001,18,24,13,9,13,2,9,26,34.6,17,19,1,18,7,31,8,0,Matches
1795,Riccardo Orsolini,it ITA,FW,Bologna,it Serie A,27-010,1997,10.7,10,5,8,0,2,4,18,22.2,14,12,2,10,6,16,14,0,Matches
1796,Stefan Ortega,de GER,GK,Manchester City,eng Premier League,31-089,1992,1.9,0,0,0,0,0,0,0,,0,0,0,0,0,0,0,1,Matches
1797,Ben Osborn,eng ENG,"DF,MF",Sheffield Utd,eng Premier League,29-182,1994,3.5,5,1,0,3,2,4,6,66.7,2,7,0,7,1,6,11,0,Matches
1798,Gabriel Osho,eng ENG,DF,Luton Town,eng Premier League,25-173,1998,10.6,21,16,9,11,1,10,14,71.4,4,23,12,11,19,40,53,0,Matches
1799,Victor Osimhen,ng NGA,FW,Napoli,it Serie A,25-036,1998,11,6,3,0,2,4,2,4,50,2,4,1,3,1,7,9,0,Matches
1800,Milutin Osmajić,me MNE,MF,Cádiz,es La Liga,24-193,1999,0.1,0,0,0,0,0,0,0,,0,0,0,0,0,0,0,0,Matches
1801,Patrick Osterhage,de GER,MF,Bochum,de Bundesliga,24-002,2000,11.6,22,15,6,15,1,8,21,38.1,13,20,6,14,14,36,16,0,Matches
1802,William Osula,dk DEN,FW,Sheffield Utd,eng Premier League,20-183,2003,6.6,1,1,1,0,0,1,2,50,1,2,1,1,1,2,4,0,Matches
1803,Dango Ouattara,bf BFA,"FW,DF",Bournemouth,eng Premier League,21-357,2002,5.1,20,11,13,4,3,9,16,56.3,7,8,2,6,6,26,13,0,Matches
1804,Kassoum Ouattara,fr FRA,DF,Monaco,fr Ligue 1,19-112,2004,2.1,9,6,4,2,3,4,6,66.7,2,3,0,3,4,13,4,0,Matches
1805,Remi Oudin,fr FRA,"MF,FW",Lecce,it Serie A,27-077,1996,12.1,16,8,5,11,0,6,9,66.7,3,9,0,9,14,30,12,0,Matches
1806,Alexandre Oukidja,dz ALG,GK,Metz,fr Ligue 1,35-199,1988,18.2,1,1,1,0,0,1,2,50,1,0,0,0,2,3,16,0,Matches
1807,Azzedine Ounahi,ma MAR,MF,Marseille,fr Ligue 1,23-290,2000,7.8,14,6,6,7,1,5,20,25,15,4,0,4,5,19,4,0,Matches
1808,Adam Ounas,dz ALG,FW,Lille,fr Ligue 1,27-084,1996,1.7,4,3,2,2,0,2,5,40,3,1,0,1,4,8,1,0,Matches
1809,Mikel Oyarzabal,es ESP,FW,Real Sociedad,es La Liga,26-288,1997,14.4,17,13,6,7,4,6,17,35.3,11,14,2,12,4,21,10,0,Matches
1810,Anthony Oyono,ga GAB,DF,Frosinone,it Serie A,22-297,2001,13.3,37,26,21,14,2,23,34,67.6,11,17,3,14,9,46,32,0,Matches
1811,Salih Özcan,tr TUR,MF,Dortmund,de Bundesliga,26-023,1998,9.5,18,9,11,7,0,10,14,71.4,4,21,2,19,14,32,12,1,Matches
1812,Bertuğ Özgür Yıldırım,tr TUR,FW,Rennes,fr Ligue 1,21-206,2002,3.6,6,4,2,2,2,3,7,42.9,4,5,0,5,0,6,4,0,Matches
1813,Cenk Özkacar,tr TUR,DF,Valencia,es La Liga,23-120,2000,6.7,12,7,9,3,0,8,14,57.1,6,7,2,5,5,17,26,1,Matches
1814,David Ozoh,eng ENG,MF,Crystal Palace,eng Premier League,18-248,2005,1.5,9,5,3,5,1,5,6,83.3,1,2,0,2,0,9,2,0,Matches
1815,Jon Pacheco,es ESP,DF,Real Sociedad,es La Liga,23-026,2001,5.9,10,6,9,1,0,4,7,57.1,3,9,4,5,3,13,26,0,Matches
1816,Willian Pacho,ec ECU,DF,Eint Frankfurt,de Bundesliga,22-110,2001,19,43,28,27,15,1,22,30,73.3,8,29,10,19,29,72,93,0,Matches
1817,Gonçalo Paciência,pt POR,FW,Bochum,de Bundesliga,29-186,1994,6.2,6,3,1,2,3,3,5,60,2,3,0,3,0,6,6,0,Matches
1818,Simone Pafundi,it ITA,MF,Udinese,it Serie A,17-354,2006,0.1,0,0,0,0,0,0,0,,0,0,0,0,0,0,0,0,Matches
1819,Riccardo Pagano,it ITA,"MF,DF",Roma,it Serie A,19-067,2004,0.6,2,2,1,1,0,0,6,0,6,3,2,1,0,2,2,0,Matches
1820,Pablo Pagis,fr FRA,MF,Lorient,fr Ligue 1,21-036,2002,1.8,10,6,5,4,1,6,10,60,4,2,0,2,3,13,1,0,Matches
1821,Exequiel Palacios,ar ARG,MF,Leverkusen,de Bundesliga,25-121,1998,15.4,46,24,19,22,5,18,38,47.4,20,18,0,18,27,73,15,2,Matches
1822,Isaac Palazón Camacho,es ESP,"MF,FW",Rayo Vallecano,es La Liga,29-038,1994,18.6,24,9,9,10,5,8,27,29.6,19,17,0,17,13,37,27,0,Matches
1823,João Palhinha,pt POR,MF,Fulham,eng Premier League,28-209,1995,17.6,93,49,54,30,9,61,95,64.2,34,37,5,32,31,124,34,0,Matches
1824,Nicolas Pallois,fr FRA,DF,Nantes,fr Ligue 1,36-137,1987,7.5,15,7,8,5,2,8,13,61.5,5,11,8,3,10,25,51,0,Matches
1825,Cole Palmer,eng ENG,MF,Manchester City,eng Premier League,21-273,2002,0.1,0,0,0,0,0,0,0,,0,0,0,0,0,0,0,0,Matches
1826,Cole Palmer,eng ENG,"FW,MF",Chelsea,eng Premier League,21-273,2002,14.6,14,8,5,3,6,6,14,42.9,8,12,1,11,9,23,10,1,Matches
1827,Emerson Palmieri,it ITA,DF,West Ham,eng Premier League,29-184,1994,20.5,61,40,27,25,9,31,44,70.5,13,28,6,22,23,84,57,0,Matches
1828,Miloš Pantović,rs SRB,MF,Union Berlin,de Bundesliga,27-211,1996,0.2,0,0,0,0,0,0,0,,0,0,0,0,0,0,0,0,Matches
1829,Antonios Papadopoulos,de GER,DF,Dortmund,de Bundesliga,24-146,1999,0.3,3,1,3,0,0,3,3,100,0,1,0,1,0,3,4,0,Matches
1830,Sokratis Papastathopoulos,gr GRE,DF,Betis,es La Liga,35-239,1988,4.1,5,4,2,3,0,5,6,83.3,1,7,4,3,3,8,21,0,Matches
1831,Matondo-Merveille Papela,de GER,"MF,DF",Mainz 05,de Bundesliga,23-016,2001,2.3,3,2,1,2,0,0,2,0,2,1,0,1,3,6,1,0,Matches
1832,Leart Paqarada,xk KVX,DF,Köln,de Bundesliga,29-118,1994,9.6,17,9,8,8,1,8,19,42.1,11,15,5,10,9,26,20,1,Matches
1833,Lucas Paquetá,br BRA,"FW,MF",West Ham,eng Premier League,26-160,1997,16.8,44,32,24,16,4,16,35,45.7,19,21,0,21,13,57,15,1,Matches
1834,Victor Parada,es ESP,"FW,MF",Alavés,es La Liga,21-305,2002,0,1,1,0,1,0,1,1,100,0,0,0,0,0,1,0,0,Matches
1835,Aitor Paredes,es ESP,DF,Athletic Club,es La Liga,23-280,2000,19.8,8,5,4,4,0,4,10,40,6,16,8,8,19,27,70,0,Matches
1836,Kevin Paredes,us USA,"FW,MF",Wolfsburg,de Bundesliga,20-272,2003,5.2,14,6,8,5,1,6,13,46.2,7,13,0,13,11,25,10,0,Matches
1837,Leandro Paredes,ar ARG,MF,Roma,it Serie A,29-219,1994,16.7,30,21,15,14,1,16,44,36.4,28,12,1,11,17,47,20,0,Matches
1838,Daniel Parejo,es ESP,MF,Villarreal,es La Liga,34-293,1989,18.5,30,21,11,19,0,15,30,50,15,12,4,8,9,39,18,3,Matches
1839,Fabiano Parisi,it ITA,DF,Fiorentina,it Serie A,23-086,2000,11,22,10,8,8,6,12,18,66.7,6,19,4,15,12,34,20,0,Matches
1840,Ben Parkinson,eng ENG,FW,Newcastle Utd,eng Premier League,18-330,2005,0.3,0,0,0,0,0,0,0,,0,1,0,1,0,0,1,0,Matches
1841,Thomas Partey,gh GHA,"DF,MF",Arsenal,eng Premier League,30-235,1993,2.8,6,5,5,1,0,4,6,66.7,2,2,1,1,4,10,2,0,Matches
1842,Mario Pašalić,hr CRO,"MF,FW",Atalanta,it Serie A,28-359,1995,9,12,6,3,9,0,4,10,40,6,15,4,11,5,17,17,0,Matches
1843,Pascu,es ESP,FW,Villarreal,es La Liga,20-300,2003,0.2,0,0,0,0,0,0,0,,0,0,0,0,0,0,0,0,Matches
1844,Felix Passlack,de GER,DF,Bochum,de Bundesliga,25-250,1998,4.8,10,7,4,5,1,7,13,53.8,6,6,1,5,5,15,10,0,Matches
1845,Patric,es ESP,DF,Lazio,it Serie A,30-292,1993,11.3,9,5,7,2,0,5,11,45.5,6,8,5,3,5,14,28,0,Matches
1846,Rui Patrício,pt POR,GK,Roma,it Serie A,35-353,1988,21,0,0,0,0,0,0,1,0,1,1,0,1,0,0,2,1,Matches
1847,Nathan Patterson,sct SCO,DF,Everton,eng Premier League,22-110,2001,10.7,33,23,21,10,2,14,37,37.8,23,14,3,11,9,42,32,0,Matches
1848,Gabriel Paulista,br BRA,DF,Valencia,es La Liga,33-069,1990,15.5,10,7,8,2,0,6,11,54.5,5,15,7,8,24,34,78,0,Matches
1849,Benjamin Pavard,fr FRA,DF,Inter,it Serie A,27-312,1996,7.3,14,9,6,7,1,6,8,75,2,11,6,5,15,29,18,0,Matches
1850,Jiří Pavlenka,cz CZE,GK,Werder Bremen,de Bundesliga,31-295,1992,7,0,0,0,0,0,0,0,,0,0,0,0,0,0,2,0,Matches
1851,Aleksandar Pavlovic,de GER,MF,Bayern Munich,de Bundesliga,19-276,2004,4.5,14,11,7,6,1,8,15,53.3,7,8,0,8,3,17,5,0,Matches
1852,Leonardo Pavoletti,it ITA,FW,Cagliari,it Serie A,35-069,1988,6.5,1,1,0,0,1,0,0,,0,2,1,1,0,1,7,0,Matches
1853,Martín Payero,ar ARG,MF,Udinese,it Serie A,25-145,1998,11.1,24,16,8,10,6,10,27,37,17,11,1,10,13,37,12,0,Matches
1854,Nicolás Paz,ar ARG,"MF,FW",Real Madrid,es La Liga,19-148,2004,0.3,0,0,0,0,0,0,0,,0,2,0,2,1,1,0,0,Matches
1855,Myles Peart-Harris,eng ENG,"DF,MF",Brentford,eng Premier League,21-138,2002,0.1,0,0,0,0,0,0,0,,0,0,0,0,0,0,1,0,Matches
1856,Sydie Peck,eng ENG,MF,Sheffield Utd,eng Premier League,19-143,2004,0.1,0,0,0,0,0,0,0,,0,0,0,0,0,0,0,0,Matches
1857,Mads Pedersen,dk DEN,DF,Augsburg,de Bundesliga,27-155,1996,12.9,33,21,15,14,4,11,23,47.8,12,15,2,13,14,47,32,0,Matches
1858,Marcus Pedersen,no NOR,DF,Sassuolo,it Serie A,23-202,2000,9.6,22,11,14,5,3,11,13,84.6,2,7,2,5,5,27,28,0,Matches
1859,Alfonso Pedraza,es ESP,DF,Villarreal,es La Liga,27-300,1996,10.6,23,8,16,5,2,9,17,52.9,8,13,5,8,11,34,17,0,Matches
1860,Pedri,es ESP,MF,Barcelona,es La Liga,21-070,2002,8.9,18,14,9,7,2,5,17,29.4,12,14,2,12,7,25,5,0,Matches
1861,Pedro,es ESP,FW,Lazio,it Serie A,36-190,1987,5.8,13,10,3,7,3,3,10,30,7,11,0,11,1,14,1,0,Matches
1862,Adrià Pedrosa,es ESP,DF,Sevilla,es La Liga,25-266,1998,14.7,36,19,19,13,4,15,24,62.5,9,16,3,13,14,50,37,0,Matches
1863,Jordan Pefok,us USA,FW,M'Gladbach,de Bundesliga,27-283,1996,7.7,5,3,0,4,1,2,5,40,3,7,2,5,1,6,14,0,Matches
1864,Jordan Pefok,us USA,FW,Union Berlin,de Bundesliga,27-283,1996,0.3,0,0,0,0,0,0,0,,0,1,1,0,0,0,0,0,Matches
1865,Dženan Pejčinović,de GER,FW,Wolfsburg,de Bundesliga,18-353,2005,0.3,0,0,0,0,0,0,0,,0,1,0,1,0,0,0,0,Matches
1866,Pietro Pellegri,it ITA,"FW,MF",Torino,it Serie A,22-323,2001,4.6,3,1,1,2,0,1,5,20,4,1,1,0,0,3,3,0,Matches
1867,Lorenzo Pellegrini,it ITA,MF,Roma,it Serie A,27-229,1996,10,20,10,5,11,4,10,28,35.7,18,14,2,12,7,27,11,0,Matches
1868,Luca Pellegrini,it ITA,DF,Lazio,it Serie A,24-333,1999,5.3,15,10,6,8,1,8,13,61.5,5,6,3,3,3,18,14,0,Matches
1869,Marco Pellegrino,,DF,Milan,it Serie A,,,0.8,1,1,0,0,1,0,2,0,2,1,1,0,1,2,2,0,Matches
1870,Facundo Pellistri,uy URU,"FW,MF",Manchester Utd,eng Premier League,22-045,2001,1.9,5,3,4,1,0,1,3,33.3,2,7,1,6,1,6,5,0,Matches
1871,Andy Pelmard,fr FRA,DF,Clermont Foot,fr Ligue 1,23-328,2000,18.2,35,24,28,7,0,21,24,87.5,3,21,10,11,15,50,34,1,Matches
1872,Aurélien Pelon,fr FRA,DF,Lorient,fr Ligue 1,19-273,2004,1,1,0,1,0,0,0,2,0,2,2,2,0,0,1,7,0,Matches
1873,Iñaki Peña,es ESP,GK,Barcelona,es La Liga,24-338,1999,9,0,0,0,0,0,0,1,0,1,0,0,0,0,0,4,1,Matches
1874,Rubén Peña,es ESP,"DF,FW",Osasuna,es La Liga,32-200,1991,14.4,35,22,17,13,5,17,41,41.5,24,23,4,19,20,55,29,3,Matches
1875,Pepín,gq EQG,"MF,FW",Monza,it Serie A,27-173,1996,2.6,6,1,1,4,1,2,4,50,2,5,2,3,0,6,5,0,Matches
1876,Alberto Perea,es ESP,"MF,FW",Granada,es La Liga,33-046,1990,0,0,0,0,0,0,0,2,0,2,0,0,0,0,0,0,0,Matches
1877,Andreas Pereira,br BRA,MF,Fulham,eng Premier League,28-033,1996,16.6,15,7,2,6,7,5,19,26.3,14,9,2,7,3,18,9,0,Matches
1878,Danilo Pereira,pt POR,DF,Paris S-G,fr Ligue 1,32-147,1991,11.4,13,7,10,2,1,3,6,50,3,18,18,0,14,27,62,0,Matches
1879,Mathias Pereira Lage,pt POR,FW,Brest,fr Ligue 1,27-065,1996,4.8,7,4,3,3,1,5,15,33.3,10,6,2,4,4,11,2,0,Matches
1880,Pedro Pereira,pt POR,DF,Monza,it Serie A,26-012,1998,6.9,8,5,5,3,0,5,12,41.7,7,14,2,12,3,11,14,0,Matches
1881,Roberto Pereyra,ar ARG,"FW,MF",Udinese,it Serie A,33-027,1991,13.2,12,5,8,4,0,7,16,43.8,9,12,2,10,3,15,6,0,Matches
1882,Ayoze Pérez,es ESP,FW,Betis,es La Liga,30-189,1993,16.2,36,22,10,22,4,12,28,42.9,16,29,2,27,17,53,12,0,Matches
1883,Carles Pérez,es ESP,"MF,FW",Celta Vigo,es La Liga,25-352,1998,4.9,6,3,2,3,1,4,9,44.4,5,8,0,8,4,10,3,0,Matches
1884,Francisco Perez,es ESP,"MF,FW",Valencia,es La Liga,21-147,2002,16.2,22,13,8,11,3,10,30,33.3,20,16,0,16,8,30,3,0,Matches
1885,Kike Pérez,es ESP,"MF,FW",Rayo Vallecano,es La Liga,26-354,1997,7,19,8,9,9,1,8,18,44.4,10,8,0,8,6,25,5,0,Matches
1886,Nehuén Pérez,ar ARG,DF,Udinese,it Serie A,23-224,2000,22,46,29,28,17,1,25,31,80.6,6,30,12,18,26,72,106,0,Matches
1887,Mattia Perin,it ITA,GK,Juventus,it Serie A,31-085,1992,2,0,0,0,0,0,0,0,,0,0,0,0,0,0,1,0,Matches
1888,Samuele Perisan,it ITA,GK,Empoli,it Serie A,26-166,1997,1,0,0,0,0,0,0,0,,0,0,0,0,0,0,0,0,Matches
1889,Ivan Perišić,hr CRO,FW,Tottenham,eng Premier League,35-001,1989,1.1,3,2,1,1,1,3,5,60,2,1,0,1,2,5,1,0,Matches
1890,Romain Perraud,fr FRA,"DF,FW",Nice,fr Ligue 1,26-134,1997,1.6,6,5,4,1,1,3,6,50,3,3,0,3,3,9,7,0,Matches
1891,Lucas Perrin,fr FRA,DF,Strasbourg,fr Ligue 1,25-076,1998,18,36,24,26,10,0,22,37,59.5,15,23,14,9,17,53,69,0,Matches
1892,Máximo Perrone,ar ARG,MF,Las Palmas,es La Liga,21-027,2003,11.3,31,16,14,15,2,14,26,53.8,12,15,3,12,20,51,14,0,Matches
1893,Pavao Pervan,at AUT,GK,Wolfsburg,de Bundesliga,36-082,1987,3,0,0,0,0,0,0,0,,0,0,0,0,0,0,1,0,Matches
1894,Matteo Pessina,it ITA,MF,Monza,it Serie A,26-288,1997,21.1,29,17,12,14,3,13,32,40.6,19,24,9,15,19,48,28,0,Matches
1895,Andrea Petagna,it ITA,FW,Cagliari,it Serie A,28-218,1995,9.9,3,1,1,0,2,1,2,50,1,5,2,3,1,4,4,0,Matches
1896,Denis Petrić,rs SRB,GK,Nantes,fr Ligue 1,35-255,1988,0.3,0,0,0,0,0,0,0,,0,0,0,0,0,0,0,0,Matches
1897,Njegoš Petrović,rs SRB,"MF,FW",Granada,es La Liga,24-200,1999,1.7,5,2,4,1,0,2,3,66.7,1,2,0,2,1,6,3,0,Matches
1898,Đorđe Petrović,rs SRB,GK,Chelsea,eng Premier League,24-118,1999,6.1,0,0,0,0,0,0,0,,0,0,0,0,0,0,3,0,Matches
1899,Jens Petter Hauge,no NOR,"MF,FW",Eint Frankfurt,de Bundesliga,24-114,1999,1.6,2,1,1,0,1,2,7,28.6,5,5,1,4,0,2,1,0,Matches
1900,Germán Pezzella,ar ARG,DF,Betis,es La Liga,32-221,1991,20.1,22,15,17,5,0,15,26,57.7,11,23,14,9,26,48,102,0,Matches
1901,Giuseppe Pezzella,it ITA,DF,Empoli,it Serie A,26-066,1997,3.7,11,8,7,3,1,9,13,69.2,4,12,4,8,0,11,9,0,Matches
1902,Luca Pfeiffer,de GER,"FW,MF",Darmstadt 98,de Bundesliga,27-167,1996,14.1,8,4,0,5,3,3,7,42.9,4,4,1,3,2,10,13,0,Matches
1903,Patric Pfeiffer,de GER,DF,Augsburg,de Bundesliga,24-167,1999,4.1,9,5,5,3,1,5,6,83.3,1,7,4,3,8,17,16,0,Matches
1904,Maximilian Philipp,de GER,"FW,MF",Freiburg,de Bundesliga,29-339,1994,2.7,7,5,4,3,0,1,5,20,4,6,0,6,0,7,0,0,Matches
1905,Kalvin Phillips,eng ENG,MF,West Ham,eng Premier League,28-063,1995,0.7,4,1,2,1,1,2,3,66.7,1,1,0,1,0,4,0,1,Matches
1906,Kalvin Phillips,eng ENG,MF,Manchester City,eng Premier League,28-063,1995,1,3,3,1,1,1,0,0,,0,0,0,0,2,5,2,0,Matches
1907,Jaden Philogene Bidace,eng ENG,FW,Aston Villa,eng Premier League,21-360,2002,0,0,0,0,0,0,0,0,,0,0,0,0,0,0,0,0,Matches
1908,Kamil Piątkowski,pl POL,DF,Granada,es La Liga,23-227,2000,1,6,3,5,1,0,1,1,100,0,3,3,0,0,6,7,0,Matches
1909,Roberto Piccoli,it ITA,FW,Empoli,it Serie A,23-007,2001,0.4,1,1,0,0,1,1,1,100,0,0,0,0,0,1,0,0,Matches
1910,Roberto Piccoli,it ITA,FW,Lecce,it Serie A,23-007,2001,6,8,4,2,4,2,1,2,50,1,6,0,6,1,9,4,0,Matches
1911,Florian Pick,de GER,"MF,FW",Heidenheim,de Bundesliga,28-148,1995,2.7,3,3,2,0,1,2,3,66.7,1,2,0,2,2,5,1,0,Matches
1912,Jordan Pickford,eng ENG,GK,Everton,eng Premier League,29-333,1994,22,0,0,0,0,0,0,0,,0,1,0,1,0,0,11,0,Matches
1913,Amos Pieper,de GER,DF,Werder Bremen,de Bundesliga,26-017,1998,6,13,10,8,5,0,7,12,58.3,5,12,7,5,8,21,34,1,Matches
1914,Marvin Pieringer,de GER,"FW,MF",Heidenheim,de Bundesliga,24-122,1999,9.5,12,9,3,7,2,6,14,42.9,8,22,4,18,10,22,12,0,Matches
1915,Santiago Pierotti,ar ARG,"MF,DF",Lecce,it Serie A,22-306,2001,0.3,2,2,1,0,1,1,2,50,1,0,0,0,0,2,0,0,Matches
1916,Niccolò Pierozzi,it ITA,DF,Salernitana,it Serie A,22-144,2001,2.1,2,2,2,0,0,1,2,50,1,8,1,7,3,5,4,0,Matches
1917,Ronaël Pierre-Gabriel,fr FRA,DF,Nantes,fr Ligue 1,25-235,1998,6.6,15,9,12,2,1,5,7,71.4,2,13,4,9,8,23,25,0,Matches
1918,Andrea Pinamonti,it ITA,FW,Sassuolo,it Serie A,24-260,1999,18.8,6,5,0,1,5,2,10,20,8,12,2,10,0,6,21,0,Matches
1919,Ethan Pinnock,jm JAM,DF,Brentford,eng Premier League,30-250,1993,21,30,19,19,11,0,6,15,40,9,31,18,13,36,66,130,2,Matches
1920,Yeremi Pino,es ESP,"MF,FW",Villarreal,es La Liga,21-106,2002,5.3,25,18,12,10,3,9,18,50,9,11,1,10,5,30,5,0,Matches
1921,Lorenzo Pirola,it ITA,DF,Salernitana,it Serie A,21-348,2002,13,23,12,14,9,0,8,16,50,8,23,17,6,11,34,56,0,Matches
1922,Niccolò Pisilli,it ITA,MF,Roma,it Serie A,19-133,2004,0.1,0,0,0,0,0,0,0,,0,0,0,0,0,0,0,0,Matches
1923,Alassane Pléa,fr FRA,"FW,MF",M'Gladbach,de Bundesliga,30-330,1993,14.7,11,6,4,5,2,4,12,33.3,8,6,0,6,1,12,3,0,Matches
1924,Tommaso Pobega,it ITA,MF,Milan,it Serie A,24-203,1999,3.3,14,8,11,3,0,5,10,50,5,8,2,6,6,20,7,0,Matches
1925,Paul Pogba,fr FRA,MF,Juventus,it Serie A,30-325,1993,0.6,1,1,0,1,0,1,1,100,0,0,0,0,1,2,1,0,Matches
1926,Ole Pohlmann,de GER,MF,Dortmund,de Bundesliga,22-304,2001,0.4,0,0,0,0,0,0,0,,0,0,0,0,0,0,0,0,Matches
1927,Matteo Politano,it ITA,FW,Napoli,it Serie A,30-184,1993,14.6,12,7,3,6,3,8,24,33.3,16,3,0,3,9,21,8,0,Matches
1928,Julien Ponceau,fr FRA,MF,Lorient,fr Ligue 1,23-067,2000,12.4,16,6,7,6,3,5,16,31.3,11,10,0,10,13,29,10,0,Matches
1929,Marin Pongračić,hr CRO,DF,Lecce,it Serie A,26-145,1997,22,28,20,14,13,1,15,21,71.4,6,23,17,6,32,60,76,0,Matches
1930,Nick Pope,eng ENG,GK,Newcastle Utd,eng Premier League,31-290,1992,13.9,0,0,0,0,0,0,1,0,1,0,0,0,0,0,7,2,Matches
1931,Pedro Porro,es ESP,DF,Tottenham,eng Premier League,24-143,1999,21,64,44,33,19,12,42,84,50,42,46,13,33,21,85,66,2,Matches
1932,Portu,es ESP,FW,Getafe,es La Liga,31-258,1992,1.1,5,3,4,0,1,5,6,83.3,1,0,0,0,0,5,0,0,Matches
1933,Portu,es ESP,"MF,FW",Girona,es La Liga,31-258,1992,5.3,9,7,0,8,1,2,11,18.2,9,4,1,3,1,10,2,0,Matches
1934,Stefan Posch,at AUT,DF,Bologna,it Serie A,26-265,1997,13.2,43,25,18,21,4,28,46,60.9,18,11,5,6,12,55,29,0,Matches
1935,Yussuf Poulsen,dk DEN,FW,RB Leipzig,de Bundesliga,29-233,1994,10.1,11,7,1,7,3,2,8,25,6,9,1,8,3,14,11,0,Matches
1936,José Pozo,es ESP,"MF,FW",Rayo Vallecano,es La Liga,27-325,1996,0.1,0,0,0,0,0,0,0,,0,0,0,0,0,0,0,0,Matches
1937,Alejandro Pozo Pozo,es ESP,"DF,MF",Almería,es La Liga,24-346,1999,9.1,16,9,9,5,2,10,18,55.6,8,13,4,9,5,21,17,0,Matches
1938,Beñat Prados,es ESP,"MF,DF",Athletic Club,es La Liga,22-360,2001,6.3,18,11,6,9,3,12,26,46.2,14,15,1,14,10,28,16,0,Matches
1939,Matteo Prati,it ITA,MF,Cagliari,it Serie A,20-037,2003,16.1,33,20,9,21,3,18,29,62.1,11,17,2,15,11,44,18,1,Matches
1940,Abdón Prats,es ESP,FW,Mallorca,es La Liga,31-058,1992,9.3,3,3,1,1,1,1,3,33.3,2,3,1,2,2,5,6,0,Matches
1941,Sanjin Prcić,ba BIH,MF,Strasbourg,fr Ligue 1,30-075,1993,1,0,0,0,0,0,0,1,0,1,2,1,1,3,3,1,0,Matches
1942,Grischa Prömel,de GER,MF,Hoffenheim,de Bundesliga,29-025,1995,15.4,24,15,8,10,6,11,28,39.3,17,14,3,11,10,34,24,0,Matches
1943,Ivan Provedel,it ITA,GK,Lazio,it Serie A,29-323,1994,21,1,0,1,0,0,1,3,33.3,2,0,0,0,0,1,9,0,Matches
1944,Pubill,es ESP,DF,Almería,es La Liga,20-228,2003,6.2,25,13,19,4,2,13,24,54.2,11,5,3,2,5,30,15,0,Matches
1945,Gustavo Puerta,co COL,"DF,MF",Leverkusen,de Bundesliga,20-195,2003,0.3,5,3,2,2,1,1,1,100,0,2,0,2,0,5,0,0,Matches
1946,Antonio Puertas,es ESP,"MF,FW",Granada,es La Liga,31-347,1992,6.9,10,7,4,5,1,5,13,38.5,8,4,0,4,5,15,4,0,Matches
1947,Arnau Puigmal,es ESP,"FW,DF",Almería,es La Liga,23-024,2001,2.8,2,1,1,1,0,1,3,33.3,2,3,0,3,3,5,2,0,Matches
1948,Christian Pulisic,us USA,FW,Milan,it Serie A,25-138,1998,16.2,21,16,9,5,7,10,15,66.7,5,12,1,11,8,29,7,0,Matches
1949,George Pușcaș,ro ROU,FW,Genoa,it Serie A,27-301,1996,2.1,0,0,0,0,0,0,3,0,3,1,0,1,0,0,1,0,Matches
1950,Jarell Quansah,eng ENG,DF,Liverpool,eng Premier League,21-005,2003,2.9,4,3,3,1,0,2,3,66.7,1,3,0,3,4,8,9,0,Matches
1951,Domingos Quina,pt POR,MF,Udinese,it Serie A,24-077,1999,0.1,1,1,1,0,0,0,0,,0,0,0,0,0,1,0,0,Matches
1952,Adrien Rabiot,fr FRA,MF,Juventus,it Serie A,28-306,1995,18,38,24,16,20,2,24,33,72.7,9,18,5,13,18,56,18,0,Matches
1953,Uroš Račić,rs SRB,MF,Sassuolo,it Serie A,25-323,1998,3.8,5,2,2,3,0,0,4,0,4,7,2,5,3,8,12,0,Matches
1954,Nemanja Radonjić,rs SRB,"MF,FW",Torino,it Serie A,27-353,1996,4.2,1,1,0,0,1,1,3,33.3,2,3,0,3,0,1,0,0,Matches
1955,Ionuț Radu,ro ROU,GK,Bournemouth,eng Premier League,26-251,1997,2,0,0,0,0,0,0,0,,0,0,0,0,0,0,0,0,Matches
1956,Boris Radunović,rs SRB,GK,Cagliari,it Serie A,27-253,1996,7,0,0,0,0,0,0,0,,0,0,0,0,1,1,1,2,Matches
1957,Hamza Rafia,tn TUN,MF,Lecce,it Serie A,24-307,1999,8.8,26,19,8,16,2,5,16,31.3,11,19,1,18,8,34,8,0,Matches
1958,Antonio Raillo,es ESP,DF,Mallorca,es La Liga,32-118,1991,11.9,14,12,9,5,0,8,12,66.7,4,23,17,6,15,29,46,1,Matches
1959,Luca Raimund,de GER,"FW,MF",Stuttgart,de Bundesliga,18-300,2005,0.3,3,1,2,1,0,0,0,,0,2,0,2,0,3,0,0,Matches
1960,Predrag Rajković,rs SRB,GK,Mallorca,es La Liga,28-095,1995,23,1,1,1,0,0,1,1,100,0,0,0,0,0,1,9,0,Matches
1961,Jesuran Rak Sakyi,eng ENG,"MF,FW",Crystal Palace,eng Premier League,21-121,2002,1.5,4,1,3,1,0,2,3,66.7,1,2,0,2,3,7,1,0,Matches
1962,Ivan Rakitić,hr CRO,MF,Sevilla,es La Liga,35-330,1988,15.8,30,16,9,12,9,11,19,57.9,8,16,5,11,14,44,12,0,Matches
1963,Ylber Ramadani,al ALB,MF,Lecce,it Serie A,27-297,1996,20.5,46,28,22,19,5,23,57,40.4,34,33,8,25,36,82,28,0,Matches
1964,Largie Ramazani,be BEL,"FW,MF",Almería,es La Liga,22-341,2001,12.8,11,7,4,6,1,6,26,23.1,20,7,2,5,21,32,5,0,Matches
1965,Benito Ramírez,es ESP,"FW,MF",Las Palmas,es La Liga,28-207,1995,1.7,4,2,1,3,0,2,4,50,2,3,1,2,1,5,0,0,Matches
1966,Sandro Ramírez,es ESP,FW,Las Palmas,es La Liga,28-209,1995,8.7,7,6,2,4,1,3,8,37.5,5,6,1,5,1,8,7,1,Matches
1967,Chris Ramos,es ESP,"FW,MF",Cádiz,es La Liga,27-016,1997,18.6,19,9,8,9,2,5,20,25,15,14,4,10,7,26,34,0,Matches
1968,Gonçalo Ramos,pt POR,FW,Paris S-G,fr Ligue 1,22-228,2001,7.6,13,7,4,4,5,5,13,38.5,8,5,1,4,0,13,8,0,Matches
1969,Sergio Ramos,es ESP,DF,Sevilla,es La Liga,37-310,1986,13,18,14,12,5,1,11,18,61.1,7,12,12,0,22,40,66,0,Matches
1970,Aaron Ramsdale,eng ENG,GK,Arsenal,eng Premier League,25-265,1998,5,0,0,0,0,0,0,0,,0,0,0,0,0,0,3,1,Matches
1971,Aaron Ramsey,eng ENG,"MF,FW",Burnley,eng Premier League,21-013,2003,3.6,12,10,5,3,4,5,11,45.5,6,8,1,7,0,12,4,0,Matches
1972,Jacob Ramsey,eng ENG,"MF,FW",Aston Villa,eng Premier League,22-251,2001,5.7,14,8,6,5,3,4,10,40,6,10,1,9,2,16,4,0,Matches
1973,Luca Ranieri,it ITA,DF,Fiorentina,it Serie A,24-286,1999,12.4,5,4,5,0,0,5,9,55.6,4,18,9,9,18,23,33,0,Matches
1974,Filippo Ranocchia,it ITA,"MF,DF",Empoli,it Serie A,22-265,2001,5.3,16,11,7,9,0,7,16,43.8,9,9,1,8,3,19,14,0,Matches
1975,Grant Ranos,am ARM,"FW,MF",M'Gladbach,de Bundesliga,20-198,2003,0.5,0,0,0,0,0,0,0,,0,0,0,0,0,0,0,0,Matches
1976,Raphinha,br BRA,"FW,MF",Barcelona,es La Liga,27-051,1996,7.4,7,4,2,4,1,2,10,20,8,10,0,10,5,12,4,0,Matches
1977,Nicolai Rapp,de GER,DF,Werder Bremen,de Bundesliga,27-052,1996,0.8,3,2,2,1,0,2,2,100,0,2,0,2,2,5,8,0,Matches
1978,Elba Rashani,xk KVX,"MF,FW",Clermont Foot,fr Ligue 1,30-270,1993,6.7,14,11,1,10,3,6,13,46.2,7,13,1,12,3,17,5,0,Matches
1979,Marcus Rashford,eng ENG,FW,Manchester Utd,eng Premier League,26-095,1997,16.5,12,6,5,2,5,5,18,27.8,13,9,1,8,3,15,12,0,Matches
1980,Giacomo Raspadori,it ITA,"FW,MF",Napoli,it Serie A,23-350,2000,12.3,16,7,4,7,5,4,9,44.4,5,7,0,7,3,19,5,0,Matches
1981,Andrei Ratiu,ro ROU,DF,Rayo Vallecano,es La Liga,25-228,1998,3.6,8,2,4,3,1,6,11,54.5,5,2,0,2,0,8,5,0,Matches
1982,Raúl,es ESP,FW,Osasuna,es La Liga,23-092,2000,6.6,6,2,3,1,2,1,6,16.7,5,4,1,3,2,8,8,0,Matches
1983,David Raum,de GER,DF,RB Leipzig,de Bundesliga,25-287,1998,18.7,33,19,14,16,3,22,37,59.5,15,29,4,25,13,46,44,2,Matches
1984,Federico Ravaglia,it ITA,GK,Bologna,it Serie A,24-084,1999,2,0,0,0,0,0,0,0,,0,0,0,0,0,0,1,0,Matches
1985,David Raya,es ESP,GK,Arsenal,eng Premier League,28-141,1995,17,0,0,0,0,0,0,0,,0,0,0,0,0,0,2,4,Matches
1986,Tim Ream,us USA,DF,Fulham,eng Premier League,36-121,1987,12.9,17,9,11,4,2,7,13,53.8,6,15,9,6,20,37,41,2,Matches
1987,Abderrahman Rebbach,dz ALG,"FW,MF",Alavés,es La Liga,25-176,1998,6.5,6,3,1,2,3,4,13,30.8,9,10,1,9,3,9,5,0,Matches
1988,Nathan Redmond,eng ENG,"FW,MF",Burnley,eng Premier League,29-334,1994,1.6,2,1,0,0,2,1,4,25,3,1,0,1,0,2,3,0,Matches
1989,Harrison Reed,eng ENG,MF,Fulham,eng Premier League,29-007,1995,8.8,14,9,4,7,3,7,17,41.2,10,10,4,6,7,21,13,0,Matches
1990,Sergio Reguilón,es ESP,DF,Manchester Utd,eng Premier League,27-049,1996,4.6,13,8,6,2,5,8,17,47.1,9,10,0,10,5,18,7,0,Matches
1991,Sergio Reguilón,es ESP,DF,Brentford,eng Premier League,27-049,1996,0.2,0,0,0,0,0,0,0,,0,2,0,2,0,0,0,0,Matches
1992,Bobby Reid,jm JAM,FW,Fulham,eng Premier League,31-001,1993,10.7,15,10,3,10,2,3,9,33.3,6,14,2,12,3,18,9,0,Matches
1993,Tijjani Reijnders,nl NED,MF,Milan,it Serie A,25-189,1998,20.7,29,14,8,19,2,13,26,50,13,16,4,12,9,38,20,0,Matches
1994,Reinier,br BRA,"MF,FW",Frosinone,it Serie A,22-015,2002,7,14,8,3,9,2,3,9,33.3,6,12,2,10,4,18,3,0,Matches
1995,Rocco Reitz,de GER,MF,M'Gladbach,de Bundesliga,21-250,2002,14.1,34,21,16,16,2,19,36,52.8,17,30,12,18,24,58,26,0,Matches
1996,Álex Remiro,es ESP,GK,Real Sociedad,es La Liga,28-316,1995,20.4,0,0,0,0,0,0,0,,0,0,0,0,0,0,15,2,Matches
1997,Guillaume Restes,fr FRA,GK,Toulouse,fr Ligue 1,18-329,2005,19,0,0,0,0,0,0,1,0,1,0,0,0,0,0,11,1,Matches
1998,Mateo Retegui,it ITA,FW,Genoa,it Serie A,24-280,1999,12.3,9,7,5,3,1,3,10,30,7,8,1,7,0,9,10,0,Matches
1999,Marco Reus,de GER,"MF,FW",Dortmund,de Bundesliga,34-248,1989,10.6,23,18,11,10,2,7,13,53.8,6,11,1,10,4,27,12,0,Matches
2000,Elvis Rexhbeçaj,de GER,MF,Augsburg,de Bundesliga,26-094,1997,17.9,25,16,10,12,3,15,30,50,15,27,6,21,18,43,13,0,Matches
2001,Gio Reyna,us USA,"MF,FW",Dortmund,de Bundesliga,21-082,2002,3.1,9,6,3,4,2,2,5,40,3,5,1,4,2,11,5,0,Matches
2002,Chadi Riad,ma MAR,DF,Betis,es La Liga,20-231,2003,12.3,17,10,9,8,0,8,13,61.5,5,11,5,6,10,27,59,0,Matches
2003,Alexsandro Ribeiro,br BRA,DF,Lille,fr Ligue 1,24-178,1999,16.4,26,19,20,6,0,12,20,60,8,17,9,8,26,52,75,0,Matches
2004,Samuele Ricci,it ITA,MF,Torino,it Serie A,22-166,2001,13.8,19,10,8,9,2,8,13,61.5,5,12,1,11,11,30,13,0,Matches
2005,Declan Rice,eng ENG,MF,Arsenal,eng Premier League,25-020,1999,21.2,47,28,23,20,4,21,37,56.8,16,24,7,17,31,78,35,0,Matches
2006,Chris Richards,us USA,"MF,DF",Crystal Palace,eng Premier League,23-312,2000,10.3,26,14,14,10,2,11,17,64.7,6,17,7,10,12,38,39,0,Matches
2007,Amir Richardson,ma MAR,MF,Reims,fr Ligue 1,22-010,2002,8.8,18,11,7,9,2,5,13,38.5,8,17,4,13,10,28,20,0,Matches
2008,Richarlison,br BRA,FW,Tottenham,eng Premier League,26-269,1997,12.2,15,10,4,7,4,2,6,33.3,4,27,5,22,8,23,16,0,Matches
2009,Marco Richter,de GER,"MF,FW",Mainz 05,de Bundesliga,26-071,1997,6.7,8,3,5,2,1,3,9,33.3,6,8,0,8,1,9,1,0,Matches
2010,Diego Rico,es ESP,DF,Getafe,es La Liga,30-345,1993,16.3,38,27,20,14,4,26,46,56.5,20,10,2,8,24,62,43,0,Matches
2011,Clemens Riedel,de GER,DF,Darmstadt 98,de Bundesliga,20-199,2003,6.2,19,11,13,5,1,12,20,60,8,8,2,6,11,30,24,0,Matches
2012,Fabian Rieder,ch SUI,MF,Rennes,fr Ligue 1,21-352,2002,2.8,6,4,1,3,2,3,6,50,3,1,1,0,2,8,1,0,Matches
2013,Jaïro Riedewald,nl NED,"MF,FW",Crystal Palace,eng Premier League,27-147,1996,2,4,1,0,2,2,1,2,50,1,0,0,0,2,6,0,0,Matches
2014,Manuel Riemann,de GER,GK,Bochum,de Bundesliga,35-147,1988,19,2,1,2,0,0,2,2,100,0,0,0,0,1,3,12,0,Matches
2015,Luis Rioja,es ESP,"FW,MF",Alavés,es La Liga,30-110,1993,19.3,21,16,7,10,4,10,27,37,17,16,0,16,12,33,20,0,Matches
2016,Rémy Riou,fr FRA,GK,Lyon,fr Ligue 1,36-181,1987,3,0,0,0,0,0,0,1,0,1,0,0,0,0,0,1,1,Matches
2017,Rodrigo Riquelme,es ESP,"DF,MF",Atlético Madrid,es La Liga,23-307,2000,9.7,14,8,9,2,3,9,27,33.3,18,11,0,11,4,18,10,0,Matches
2018,Mihailo Ristić,rs SRB,"DF,MF",Celta Vigo,es La Liga,28-095,1995,5.8,9,6,5,4,0,6,7,85.7,1,6,1,5,4,13,14,0,Matches
2019,Matt Ritchie,sct SCO,FW,Newcastle Utd,eng Premier League,34-146,1989,1.2,3,2,1,2,0,2,3,66.7,1,0,0,0,1,4,5,0,Matches
2020,Gorka Rivera Alonso,es ESP,DF,Getafe,es La Liga,19-186,2004,0,0,0,0,0,0,0,0,,0,0,0,0,0,0,0,0,Matches
2021,Sergi Roberto,es ESP,"MF,DF",Barcelona,es La Liga,31-361,1992,4,5,4,1,4,0,2,4,50,2,1,1,0,2,7,1,0,Matches
2022,Lucas Robertone,ar ARG,MF,Almería,es La Liga,26-322,1997,14.6,33,21,11,16,6,14,31,45.2,17,23,6,17,29,62,22,0,Matches
2023,Connor Roberts,wls WAL,DF,Burnley,eng Premier League,28-133,1995,9.1,12,5,6,4,2,8,17,47.1,9,8,6,2,4,16,25,2,Matches
2024,Andrew Robertson,sct SCO,DF,Liverpool,eng Premier League,29-329,1994,8.2,16,11,11,4,1,11,18,61.1,7,6,3,3,8,24,21,0,Matches
2025,Antonee Robinson,us USA,DF,Fulham,eng Premier League,26-179,1997,20.4,54,32,35,13,6,32,60,53.3,28,28,2,26,55,109,61,2,Matches
2026,Jack Robinson,eng ENG,DF,Sheffield Utd,eng Premier League,30-155,1993,20.3,27,16,19,8,0,19,28,67.9,9,33,21,12,21,48,91,2,Matches
2027,Marc Roca,es ESP,MF,Betis,es La Liga,27-069,1996,17.8,37,25,13,20,4,21,40,52.5,19,22,4,18,14,51,17,1,Matches
2028,Sebastian Rode,de GER,MF,Eint Frankfurt,de Bundesliga,33-115,1990,0.4,3,2,0,2,1,2,3,66.7,1,0,0,0,1,4,0,0,Matches
2029,Rodri,es ESP,MF,Manchester City,eng Premier League,27-226,1996,17.1,37,20,13,19,5,18,30,60,12,12,4,8,16,53,20,3,Matches
2030,Rodri,es ESP,"FW,MF",Betis,es La Liga,23-263,2000,7.3,13,7,4,7,2,7,16,43.8,9,8,0,8,5,18,1,0,Matches
2031,Óscar Rodríguez Arnaiz,es ESP,"MF,FW",Getafe,es La Liga,25-220,1998,3.5,8,5,1,6,1,2,5,40,3,1,0,1,3,11,1,0,Matches
2032,Dani Rodríguez,es ESP,"MF,FW",Mallorca,es La Liga,35-242,1988,19,34,18,13,15,6,18,36,50,18,22,4,18,10,44,13,0,Matches
2033,Guido Rodríguez,ar ARG,MF,Betis,es La Liga,29-297,1994,11.9,22,12,12,7,3,16,31,51.6,15,16,3,13,15,37,30,0,Matches
2034,Jay Rodriguez,eng ENG,FW,Burnley,eng Premier League,34-189,1989,7.8,12,8,5,4,3,6,10,60,4,9,1,8,1,13,7,0,Matches
2035,Kirian Rodríguez,es ESP,MF,Las Palmas,es La Liga,27-335,1996,19.7,29,19,16,11,2,15,41,36.6,26,21,3,18,15,44,14,0,Matches
2036,Miguel Rodríguez,es ESP,MF,Celta Vigo,es La Liga,20-280,2003,2.1,4,2,2,1,1,2,6,33.3,4,5,0,5,2,6,0,0,Matches
2037,Ricardo Rodríguez,ch SUI,DF,Torino,it Serie A,31-162,1992,19.9,35,21,14,20,1,22,35,62.9,13,12,5,7,20,55,46,1,Matches
2038,Rodrygo,br BRA,FW,Real Madrid,es La Liga,23-025,2001,17.2,9,9,2,5,2,2,11,18.2,9,6,0,6,6,15,1,0,Matches
2039,Mads Roerslev,dk DEN,DF,Brentford,eng Premier League,24-224,1999,10,22,14,17,5,0,13,30,43.3,17,7,1,6,10,32,35,0,Matches
2040,Rogério,br BRA,"DF,MF",Wolfsburg,de Bundesliga,26-021,1998,8.1,11,4,6,3,2,9,13,69.2,4,15,5,10,4,15,17,1,Matches
2041,Merlin Röhl,de GER,"MF,FW",Freiburg,de Bundesliga,21-213,2002,11.3,15,9,8,5,2,5,14,35.7,9,19,2,17,6,21,17,0,Matches
2042,Alessio Romagnoli,it ITA,DF,Lazio,it Serie A,29-022,1995,13.8,11,7,4,7,0,6,8,75,2,18,11,7,14,25,58,0,Matches
2043,Simone Romagnoli,it ITA,DF,Frosinone,it Serie A,33-359,1990,16.9,19,7,11,7,1,8,11,72.7,3,23,15,8,18,37,88,0,Matches
2044,Carlos Romero,es ESP,DF,Villarreal,es La Liga,22-097,2001,2.7,10,5,7,1,2,6,11,54.5,5,3,0,3,1,11,9,0,Matches
2045,Cristian Romero,ar ARG,DF,Tottenham,eng Premier League,25-282,1998,15,37,25,25,11,1,19,24,79.2,5,22,10,12,21,58,58,0,Matches
2046,Luka Romero,ar ARG,"FW,MF",Milan,it Serie A,19-077,2004,1,0,0,0,0,0,0,3,0,3,2,0,2,0,0,0,0,Matches
2047,Luka Romero,ar ARG,FW,Almería,es La Liga,19-077,2004,0.1,0,0,0,0,0,0,0,,0,2,0,2,0,0,0,0,Matches
2048,Oriol Romeu,es ESP,MF,Barcelona,es La Liga,32-132,1991,7.9,24,15,13,10,1,10,16,62.5,6,9,2,7,8,32,12,0,Matches
2049,Valentin Rongier,fr FRA,MF,Marseille,fr Ligue 1,29-058,1994,9.5,23,12,9,12,2,14,26,53.8,12,16,4,12,15,38,18,0,Matches
2050,Frank Ronstadt,de GER,"DF,MF",Darmstadt 98,de Bundesliga,26-197,1997,0.8,1,0,0,1,0,0,1,0,1,1,0,1,1,2,3,0,Matches
2051,Marten de Roon,nl NED,"MF,DF",Atalanta,it Serie A,32-311,1991,20,56,29,27,25,4,26,59,44.1,33,21,6,15,29,85,40,0,Matches
2052,Unai Ropero,es ESP,MF,Alavés,es La Liga,22-075,2001,0.1,0,0,0,0,0,0,0,,0,0,0,0,0,0,0,0,Matches
2053,Vitor Roque,br BRA,FW,Barcelona,es La Liga,18-340,2005,0.9,0,0,0,0,0,0,0,,0,0,0,0,0,0,2,0,Matches
2054,Pablo Rosario,nl NED,"DF,MF",Nice,fr Ligue 1,27-027,1997,11.4,19,13,9,9,1,11,15,73.3,4,11,6,5,11,30,17,0,Matches
2055,Joe Rothwell,eng ENG,MF,Bournemouth,eng Premier League,29-023,1995,4.3,7,2,4,2,1,2,8,25,6,4,2,2,3,10,2,0,Matches
2056,Anthony Rouault,fr FRA,DF,Stuttgart,de Bundesliga,22-250,2001,6.6,15,9,10,4,1,9,12,75,3,8,4,4,5,20,13,0,Matches
2057,Jérôme Roussillon,fr FRA,DF,Union Berlin,de Bundesliga,31-028,1993,6.3,10,5,3,4,3,4,8,50,4,10,4,6,4,14,17,0,Matches
2058,Nicolò Rovella,it ITA,MF,Lazio,it Serie A,22-061,2001,11.9,34,23,18,12,4,13,31,41.9,18,24,5,19,18,52,22,0,Matches
2059,Amir Rrahmani,xk KVX,DF,Napoli,it Serie A,29-344,1994,15.5,15,12,8,7,0,10,20,50,10,14,7,7,11,26,47,0,Matches
2060,Ruan,br BRA,DF,Sassuolo,it Serie A,24-241,1999,10.5,11,6,5,4,2,3,6,50,3,11,9,2,16,27,44,1,Matches
2061,Pelly Ruddock Mpanzu,cd COD,MF,Luton Town,eng Premier League,30-201,1993,8.4,8,1,2,6,0,4,8,50,4,10,4,6,6,14,13,1,Matches
2062,Antonio Rüdiger,de GER,DF,Real Madrid,es La Liga,30-337,1993,20,18,12,13,2,3,14,18,77.8,4,20,16,4,9,27,55,0,Matches
2063,Fabian Rüdlin,de GER,MF,Freiburg,de Bundesliga,27-021,1997,0.1,1,0,0,0,1,0,0,,0,0,0,0,0,1,0,0,Matches
2064,Daniele Rugani,it ITA,DF,Juventus,it Serie A,29-189,1994,7.3,4,3,3,1,0,0,1,0,1,7,2,5,7,11,30,0,Matches
2065,Matteo Ruggeri,it ITA,"DF,MF",Atalanta,it Serie A,21-207,2002,17.4,18,9,10,4,4,12,22,54.5,10,29,2,27,16,34,22,0,Matches
2066,Mário Rui,pt POR,DF,Napoli,it Serie A,32-252,1991,8.7,20,10,14,2,4,10,14,71.4,4,9,2,7,9,29,17,0,Matches
2067,Aitor Ruibal,es ESP,"DF,FW",Betis,es La Liga,27-318,1996,7.8,35,19,21,12,2,24,46,52.2,22,8,1,7,10,45,21,0,Matches
2068,Fabián Ruiz Peña,es ESP,MF,Paris S-G,fr Ligue 1,27-306,1996,9,28,17,15,9,4,18,28,64.3,10,7,2,5,7,35,16,1,Matches
2069,Sergio Ruiz,es ESP,MF,Granada,es La Liga,29-049,1994,14.4,39,21,18,17,4,17,40,42.5,23,14,5,9,13,52,28,1,Matches
2070,Julian Ryerson,no NOR,DF,Dortmund,de Bundesliga,26-078,1997,9.9,22,15,15,5,2,17,24,70.8,7,16,2,14,6,28,20,2,Matches
2071,Frederik Rønnow,dk DEN,GK,Union Berlin,de Bundesliga,31-183,1992,18,0,0,0,0,0,0,0,,0,0,0,0,1,1,14,1,Matches
2072,José Sá,pt POR,GK,Wolves,eng Premier League,31-017,1993,19.2,0,0,0,0,0,0,0,,0,3,0,3,0,0,10,3,Matches
2073,Youssouf Sabaly,sn SEN,DF,Betis,es La Liga,30-335,1993,3,6,3,5,0,1,2,3,66.7,1,3,1,2,3,9,10,0,Matches
2074,Emmanuel Sabbi,us USA,"MF,FW",Le Havre,fr Ligue 1,26-041,1997,6.1,9,3,4,3,2,5,14,35.7,9,12,1,11,5,14,3,0,Matches
2075,Stefano Sabelli,it ITA,DF,Genoa,it Serie A,31-021,1993,17.1,33,15,17,14,2,10,27,37,17,22,4,18,16,49,20,0,Matches
2076,Marcel Sabitzer,at AUT,MF,Dortmund,de Bundesliga,29-323,1994,13.3,27,17,13,13,1,14,31,45.2,17,24,9,15,7,34,23,0,Matches
2077,Falaye Sacko,ml MLI,DF,Montpellier,fr Ligue 1,28-278,1995,13.9,27,15,12,10,5,21,32,65.6,11,18,7,11,21,48,32,0,Matches
2078,Umar Sadiq,ng NGA,FW,Real Sociedad,es La Liga,27-001,1997,8.6,11,7,2,5,4,3,6,50,3,7,0,7,0,11,6,0,Matches
2079,Alexis Saelemaekers,be BEL,FW,Bologna,it Serie A,24-221,1999,9.9,16,11,9,5,2,7,15,46.7,8,6,1,5,4,20,6,1,Matches
2080,Wesley Saïd,fr FRA,"FW,MF",Lens,fr Ligue 1,28-290,1995,6.4,3,0,0,1,2,1,4,25,3,3,0,3,3,6,1,0,Matches
2081,Théo Sainte-Luce,fr FRA,DF,Montpellier,fr Ligue 1,25-106,1998,3.8,17,7,10,6,1,11,19,57.9,8,9,4,5,3,20,15,0,Matches
2082,Bukayo Saka,eng ENG,FW,Arsenal,eng Premier League,22-151,2001,20.4,44,24,15,14,15,17,37,45.9,20,32,2,30,10,54,9,1,Matches
2083,Mamadou Sakho,fr FRA,DF,Montpellier,fr Ligue 1,33-355,1990,0.1,1,1,1,0,0,1,1,100,0,0,0,0,0,1,1,0,Matches
2084,Ibrahim Salah,ma MAR,"FW,MF",Rennes,fr Ligue 1,22-157,2001,3.2,8,5,1,4,3,6,8,75,2,3,0,3,6,14,4,0,Matches
2085,Mohamed Salah,eg EGY,FW,Liverpool,eng Premier League,31-233,1992,19.3,13,9,0,5,8,5,17,29.4,12,14,1,13,2,15,0,0,Matches
2086,Amine Salama,fr FRA,FW,Reims,fr Ligue 1,23-200,2000,3.5,0,0,0,0,0,0,0,,0,1,0,1,1,1,1,0,Matches
2087,Kike Salas,es ESP,DF,Sevilla,es La Liga,21-286,2002,6.1,15,11,8,6,1,8,15,53.3,7,6,3,3,12,27,31,0,Matches
2088,William Saliba,fr FRA,DF,Arsenal,eng Premier League,22-316,2001,22,23,14,13,10,0,13,14,92.9,1,17,9,8,18,41,48,2,Matches
2089,Mohammed Salisu,gh GHA,DF,Monaco,fr Ligue 1,24-292,1999,4,10,7,2,6,2,7,10,70,3,12,6,6,9,19,21,0,Matches
2090,Roland Sallai,hu HUN,"MF,FW",Freiburg,de Bundesliga,26-257,1997,10.4,9,3,4,3,2,4,12,33.3,8,15,1,14,3,12,17,0,Matches
2091,Yoann Salmier,gf GUF,DF,Le Havre,fr Ligue 1,31-074,1992,12.1,18,9,10,5,3,11,17,64.7,6,17,12,5,17,35,42,0,Matches
2092,Salvi,es ESP,MF,Rayo Vallecano,es La Liga,32-310,1991,0.3,0,0,0,0,0,0,4,0,4,0,0,0,1,1,0,0,Matches
2093,Lazar Samardzic,rs SRB,MF,Udinese,it Serie A,21-344,2002,14.7,18,9,10,6,2,7,19,36.8,12,15,5,10,7,25,13,0,Matches
2094,Diadie Samassékou,ml MLI,MF,Hoffenheim,de Bundesliga,28-023,1996,0,0,0,0,0,0,0,0,,0,0,0,0,1,1,0,0,Matches
2095,Mama Samba Baldé,gw GNB,"FW,MF",Lyon,fr Ligue 1,28-089,1995,4.5,5,3,0,1,4,2,6,33.3,4,0,0,0,1,6,1,1,Matches
2096,Brice Samba,fr FRA,GK,Lens,fr Ligue 1,29-284,1994,19,0,0,0,0,0,0,0,,0,0,0,0,0,0,5,2,Matches
2097,Albert Sambi Lokonga,be BEL,MF,Luton Town,eng Premier League,24-104,1999,6.2,10,6,6,3,1,5,9,55.6,4,8,5,3,2,12,3,0,Matches
2098,Junior Sambia,fr FRA,"DF,MF",Salernitana,it Serie A,27-149,1996,3.3,2,1,2,0,0,2,3,66.7,1,2,0,2,4,6,5,0,Matches
2099,Fede San Emeterio,es ESP,MF,Cádiz,es La Liga,26-324,1997,1.7,3,2,2,1,0,1,4,25,3,3,2,1,2,5,1,0,Matches
2100,Antonio Sanabria,py PAR,"FW,MF",Torino,it Serie A,27-336,1996,13.5,12,10,4,6,2,4,7,57.1,3,4,0,4,5,17,6,0,Matches
2101,Marciano Sanca,gw GNB,"FW,MF",Almería,es La Liga,19-337,2004,0.5,0,0,0,0,0,0,0,,0,0,0,0,0,0,0,0,Matches
2102,Oihan Sancet,es ESP,MF,Athletic Club,es La Liga,23-284,2000,16.9,17,11,3,8,6,6,16,37.5,10,4,1,3,7,24,4,0,Matches
2103,Renato Sanches,pt POR,MF,Roma,it Serie A,26-169,1997,1.3,2,1,1,1,0,2,3,66.7,1,1,0,1,0,2,1,0,Matches
2104,Ricard Sánchez,es ESP,DF,Granada,es La Liga,23-346,2000,16.9,16,8,6,5,5,5,12,41.7,7,19,1,18,10,26,44,0,Matches
2105,Alexis Sánchez,cl CHI,FW,Inter,it Serie A,35-046,1988,2,1,1,0,1,0,0,0,,0,1,0,1,1,2,2,0,Matches
2106,Antonio Sánchez,es ESP,"MF,FW",Mallorca,es La Liga,27-033,1997,10.3,19,7,10,8,1,10,24,41.7,14,16,5,11,7,26,8,0,Matches
2107,Davinson Sánchez,co COL,DF,Tottenham,eng Premier League,27-236,1996,0.9,0,0,0,0,0,0,0,,0,3,2,1,1,1,2,0,Matches
2108,Juanlu Sánchez,es ESP,DF,Sevilla,es La Liga,20-172,2003,10.2,41,26,23,15,3,25,41,61,16,18,5,13,10,51,28,0,Matches
2109,Manu Sánchez,es ESP,DF,Celta Vigo,es La Liga,23-163,2000,14.7,40,22,19,16,5,23,39,59,16,18,2,16,13,53,47,0,Matches
2110,Robert Sánchez,es ESP,GK,Chelsea,eng Premier League,26-077,1997,15.9,0,0,0,0,0,0,0,,0,0,0,0,0,0,11,3,Matches
2111,Jadon Sancho,eng ENG,"FW,MF",Manchester Utd,eng Premier League,23-315,2000,0.9,1,0,1,0,0,1,3,33.3,2,1,0,1,1,2,0,0,Matches
2112,Jadon Sancho,eng ENG,"FW,MF",Dortmund,de Bundesliga,23-315,2000,2,2,1,0,1,1,0,0,,0,2,0,2,1,3,2,0,Matches
2113,Alex Sandro,br BRA,DF,Juventus,it Serie A,33-008,1991,4.5,8,3,3,5,0,3,4,75,1,6,3,3,8,16,16,0,Matches
2114,Ibou Sané,sn SEN,"FW,MF",Metz,fr Ligue 1,18-312,2005,1,4,3,2,0,2,2,2,100,0,3,0,3,0,4,2,0,Matches
2115,Leroy Sané,de GER,FW,Bayern Munich,de Bundesliga,28-023,1996,18.4,11,6,5,4,2,4,16,25,12,9,0,9,3,14,2,0,Matches
2116,Sadibou Sané,sn SEN,DF,Metz,fr Ligue 1,19-238,2004,0.5,1,0,1,0,0,0,0,,0,0,0,0,1,2,0,0,Matches
2117,Arouna Sangante,sn SEN,DF,Le Havre,fr Ligue 1,21-297,2002,16,30,20,16,13,1,11,21,52.4,10,20,14,6,40,70,48,0,Matches
2118,Ibrahim Sangaré,ci CIV,MF,Nott'ham Forest,eng Premier League,26-063,1997,9.1,32,16,17,11,4,9,21,42.9,12,20,6,14,10,42,19,0,Matches
2119,Morgan Sanson,fr FRA,MF,Nice,fr Ligue 1,29-169,1994,15.3,19,13,6,7,6,10,22,45.5,12,20,5,15,16,35,9,0,Matches
2120,Nicola Sansone,it ITA,"FW,MF",Lecce,it Serie A,32-146,1991,4.6,6,4,4,1,1,3,10,30,7,3,1,2,3,9,1,0,Matches
2121,Baptiste Santamaria,fr FRA,MF,Rennes,fr Ligue 1,28-331,1995,10.3,26,17,12,9,5,14,23,60.9,9,5,2,3,13,39,14,0,Matches
2122,Jesús Santiago,es ESP,MF,Getafe,es La Liga,19-254,2004,0.9,2,1,0,0,2,1,1,100,0,0,0,0,0,2,0,0,Matches
2123,Andrey Santos,br BRA,MF,Nott'ham Forest,eng Premier League,19-276,2004,0.1,0,0,0,0,0,0,0,,0,1,0,1,0,0,0,0,Matches
2124,Tiago santos,pt POR,DF,Lille,fr Ligue 1,21-195,2002,12.4,32,23,12,12,8,17,32,53.1,15,13,1,12,9,41,15,0,Matches
2125,Riccardo Saponara,it ITA,"FW,MF",Hellas Verona,it Serie A,32-044,1991,3.8,3,1,2,0,1,1,7,14.3,6,4,0,4,0,3,2,0,Matches
2126,Pablo Sarabia,es ESP,"FW,MF",Wolves,eng Premier League,31-268,1992,8.6,11,7,6,4,1,6,17,35.3,11,8,1,7,5,16,4,0,Matches
2127,Amin Sarr,se SWE,"FW,MF",Lyon,fr Ligue 1,22-329,2001,1.1,1,0,0,1,0,0,0,,0,1,0,1,0,1,1,0,Matches
2128,Amin Sarr,se SWE,"FW,MF",Wolfsburg,de Bundesliga,22-329,2001,1.1,0,0,0,0,0,0,0,,0,1,1,0,0,0,0,0,Matches
2129,Bouna Sarr,sn SEN,DF,Bayern Munich,de Bundesliga,32-003,1992,1.2,2,0,1,1,0,2,2,100,0,3,0,3,0,2,1,0,Matches
2130,Ismaila Sarr,sn SEN,"FW,MF",Marseille,fr Ligue 1,25-343,1998,9.2,9,5,1,7,1,2,11,18.2,9,10,3,7,9,18,2,0,Matches
2131,Mamadou Sarr,fr FRA,DF,Lyon,fr Ligue 1,18-158,2005,0.1,0,0,0,0,0,0,0,,0,0,0,0,0,0,0,0,Matches
2132,Martin Satriano,uy URU,FW,Brest,fr Ligue 1,22-348,2001,8.9,10,8,3,7,0,5,10,50,5,9,3,6,4,14,16,0,Matches
2133,Téji Savanier,fr FRA,MF,Montpellier,fr Ligue 1,32-043,1991,18.4,26,14,12,10,4,8,40,20,32,24,7,17,21,47,18,1,Matches
2134,Stefan Savić,me MNE,DF,Atlético Madrid,es La Liga,33-026,1991,10,14,11,8,5,1,6,16,37.5,10,21,10,11,19,33,30,1,Matches
2135,Sávio,br BRA,"MF,FW",Girona,es La Liga,19-299,2004,19.2,22,16,6,13,3,8,16,50,8,22,0,22,9,31,8,1,Matches
2136,Saba Sazonov,ge GEO,DF,Torino,it Serie A,22-002,2002,1.8,4,4,3,1,0,2,2,100,0,4,4,0,1,5,12,0,Matches
2137,Joe Scally,us USA,DF,M'Gladbach,de Bundesliga,21-034,2002,15.9,32,22,16,14,2,19,30,63.3,11,20,7,13,15,47,53,2,Matches
2138,Giorgio Scalvini,it ITA,DF,Atalanta,it Serie A,20-054,2003,16.9,38,23,23,13,2,11,19,57.9,8,33,12,21,39,77,44,0,Matches
2139,Gianluca Scamacca,it ITA,FW,Atalanta,it Serie A,25-033,1999,8.5,7,4,2,2,3,3,5,60,2,4,0,4,2,9,7,0,Matches
2140,Kevin Schade,de GER,"FW,MF",Brentford,eng Premier League,22-068,2001,2.9,2,1,1,1,0,0,3,0,3,0,0,0,1,3,3,0,Matches
2141,András Schäfer,hu HUN,MF,Union Berlin,de Bundesliga,24-296,1999,3.3,6,5,1,4,1,3,7,42.9,4,6,0,6,6,12,1,0,Matches
2142,Fabian Schär,ch SUI,DF,Newcastle Utd,eng Premier League,32-045,1991,21.1,26,17,19,6,1,11,22,50,11,32,25,7,20,46,87,0,Matches
2143,Patrik Schick,cz CZE,FW,Leverkusen,de Bundesliga,28-010,1996,4.3,2,2,0,0,2,0,1,0,1,1,0,1,1,3,1,0,Matches
2144,Stefan Schimmer,de GER,"MF,FW",Heidenheim,de Bundesliga,29-281,1994,1.1,1,1,0,1,0,0,3,0,3,1,0,1,1,2,4,0,Matches
2145,Xaver Schlager,at AUT,MF,RB Leipzig,de Bundesliga,26-128,1997,16.6,46,29,21,21,4,14,34,41.2,20,23,5,18,14,60,11,0,Matches
2146,Keven Schlotterbeck,de GER,DF,Bochum,de Bundesliga,26-281,1997,10,20,11,15,4,1,11,12,91.7,1,15,11,4,13,33,43,0,Matches
2147,Nico Schlotterbeck,de GER,DF,Dortmund,de Bundesliga,24-064,1999,18.5,31,21,16,14,1,17,32,53.1,15,28,15,13,21,52,65,2,Matches
2148,Jeffrey Schlupp,gh GHA,"FW,MF",Crystal Palace,eng Premier League,31-042,1992,13.1,33,19,14,14,5,8,16,50,8,12,2,10,7,40,23,0,Matches
2149,Romano Schmid,at AUT,MF,Werder Bremen,de Bundesliga,24-007,2000,15.5,21,13,5,12,4,11,28,39.3,17,18,1,17,5,26,9,2,Matches
2150,Kenneth Schmidt,de GER,DF,Freiburg,de Bundesliga,21-245,2002,0.8,2,2,2,0,0,2,4,50,2,1,0,1,1,3,2,0,Matches
2151,Niklas Schmidt,de GER,MF,Toulouse,fr Ligue 1,25-339,1998,9.8,29,18,11,15,3,13,22,59.1,9,8,5,3,4,33,10,0,Matches
2152,Benno Schmitz,de GER,DF,Köln,de Bundesliga,29-078,1994,6.7,14,8,12,2,0,9,19,47.4,10,12,2,10,4,18,15,0,Matches
2153,Fabian Schnellhardt,de GER,MF,Darmstadt 98,de Bundesliga,30-022,1994,2.3,4,1,2,1,1,1,3,33.3,2,1,0,1,4,8,5,0,Matches
2154,Jan Schöppner,de GER,MF,Heidenheim,de Bundesliga,24-236,1999,9.9,15,6,8,7,0,7,14,50,7,12,3,9,12,27,24,0,Matches
2155,Marcel Schuhen,de GER,GK,Darmstadt 98,de Bundesliga,31-021,1993,18,0,0,0,0,0,0,1,0,1,0,0,0,0,0,5,3,Matches
2156,Perr Schuurs,nl NED,DF,Torino,it Serie A,24-069,1999,8.6,20,12,11,8,1,3,9,33.3,6,10,2,8,9,29,23,0,Matches
2157,Marvin Schwäbe,de GER,GK,Köln,de Bundesliga,28-284,1995,19,1,0,1,0,0,1,1,100,0,0,0,0,0,1,9,0,Matches
2158,Alex Scott,eng ENG,MF,Bournemouth,eng Premier League,20-166,2003,4.9,8,5,3,4,1,4,9,44.4,5,7,2,5,7,15,8,1,Matches
2159,Simone Scuffet,it ITA,GK,Cagliari,it Serie A,27-248,1996,15,1,0,1,0,0,1,1,100,0,1,0,1,1,2,5,0,Matches
2160,Jérémy Sebas,mq MTQ,FW,Strasbourg,fr Ligue 1,20-295,2003,0.7,2,0,1,1,0,1,2,50,1,0,0,0,0,2,0,0,Matches
2161,Manuel Sebastián,es ESP,MF,Sevilla,es La Liga,19-191,2004,0.2,1,0,1,0,0,1,1,100,0,2,0,2,0,1,0,0,Matches
2162,Demba Seck,sn SEN,MF,Torino,it Serie A,22-358,2001,4.7,5,3,1,4,0,3,4,75,1,1,0,1,1,6,0,0,Matches
2163,Demba Seck,sn SEN,FW,Frosinone,it Serie A,22-358,2001,0.8,3,1,1,1,1,1,1,100,0,2,0,2,0,3,0,0,Matches
2164,Aleksandar Sedlar,rs SRB,DF,Alavés,es La Liga,32-052,1991,10.5,14,10,10,4,0,10,16,62.5,6,8,4,4,13,27,43,0,Matches
2165,Alidu Seidu,gh GHA,DF,Clermont Foot,fr Ligue 1,23-244,2000,12.6,32,24,17,15,0,24,31,77.4,7,15,7,8,25,57,37,0,Matches
2166,Nicolas Seiwald,at AUT,MF,RB Leipzig,de Bundesliga,22-275,2001,3.2,13,7,9,3,1,6,11,54.5,5,5,1,4,3,16,1,0,Matches
2167,Davie Selke,de GER,FW,Köln,de Bundesliga,29-014,1995,12,4,2,1,3,0,0,2,0,2,4,2,2,0,4,16,0,Matches
2168,Matz Sels,be BEL,GK,Strasbourg,fr Ligue 1,31-342,1992,19,0,0,0,0,0,0,0,,0,2,0,2,0,0,13,1,Matches
2169,Nélson Semedo,pt POR,"DF,MF",Wolves,eng Premier League,30-079,1993,20.2,53,32,33,13,7,25,42,59.5,17,25,7,18,20,73,51,0,Matches
2170,Vivaldo Semedo,pt POR,FW,Udinese,it Serie A,19-006,2005,0.1,0,0,0,0,0,0,0,,0,0,0,0,0,0,0,0,Matches
2171,Antoine Semenyo,gh GHA,FW,Bournemouth,eng Premier League,24-027,2000,10.2,13,9,5,4,4,5,11,45.5,6,11,1,10,3,16,6,0,Matches
2172,Marvin Senaya,tg TOG,DF,Strasbourg,fr Ligue 1,23-006,2001,13.3,46,32,27,15,4,29,47,61.7,18,23,9,14,26,72,40,0,Matches
2173,Marcos Senesi,ar ARG,DF,Bournemouth,eng Premier League,26-269,1997,14.4,32,15,17,14,1,12,33,36.4,21,31,17,14,16,48,65,1,Matches
2174,Stefano Sensi,it ITA,MF,Inter,it Serie A,28-182,1995,0.3,0,0,0,0,0,0,1,0,1,1,0,1,1,1,0,0,Matches
2175,Suat Serdar,de GER,MF,Hellas Verona,it Serie A,26-298,1997,5.3,17,12,7,9,1,6,11,54.5,5,4,0,4,5,22,7,0,Matches
2176,Benjamin Šeško,si SVN,FW,RB Leipzig,de Bundesliga,20-248,2003,6.4,7,2,2,4,1,1,4,25,3,15,1,14,1,8,10,0,Matches
2177,Kevin Sessa,de GER,"MF,FW",Heidenheim,de Bundesliga,23-212,2000,3.7,6,2,4,1,1,3,8,37.5,5,6,1,5,1,7,5,0,Matches
2178,Aaron Seydel,de GER,FW,Darmstadt 98,de Bundesliga,27-361,1996,2.9,2,1,0,2,0,0,0,,0,5,2,3,0,2,5,0,Matches
2179,Stephan El Shaarawy,it ITA,"FW,DF",Roma,it Serie A,31-099,1992,10.2,12,6,9,3,0,2,7,28.6,5,7,3,4,4,16,8,0,Matches
2180,Luke Shaw,eng ENG,DF,Manchester Utd,eng Premier League,28-206,1995,8.7,9,7,5,3,1,7,12,58.3,5,16,10,6,5,14,34,0,Matches
2181,Eldor Shomurodov,uz UZB,"FW,MF",Cagliari,it Serie A,28-219,1995,3.5,2,1,0,1,1,2,5,40,3,1,0,1,1,3,0,0,Matches
2182,Steven Shpendi,al ALB,"FW,MF",Empoli,it Serie A,20-260,2003,4.4,0,0,0,0,0,0,4,0,4,2,1,1,1,1,0,0,Matches
2183,Sofiane Sidi Ali,fr FRA,MF,Marseille,fr Ligue 1,28-204,1995,0.1,2,0,0,2,0,1,1,100,0,0,0,0,1,3,0,0,Matches
2184,Vincent Sierro,ch SUI,MF,Toulouse,fr Ligue 1,28-118,1995,13.3,17,8,3,10,4,11,37,29.7,26,19,6,13,15,32,15,0,Matches
2185,Tim Siersleben,de GER,DF,Heidenheim,de Bundesliga,23-331,2000,9.5,25,9,19,6,0,8,19,42.1,11,16,10,6,20,45,26,1,Matches
2186,Kiliann Sildillia,fr FRA,DF,Freiburg,de Bundesliga,21-263,2002,14.5,28,13,18,5,5,18,29,62.1,11,21,8,13,14,42,42,0,Matches
2187,André Silva,pt POR,FW,Real Sociedad,es La Liga,28-089,1995,2.1,0,0,0,0,0,0,2,0,2,1,0,1,0,0,0,0,Matches
2188,Bernardo Silva,pt POR,"MF,FW",Manchester City,eng Premier League,29-177,1994,15.8,31,15,9,16,6,17,34,50,17,17,3,14,4,35,9,1,Matches
2189,Caio Henrique Oliveira Silva,br BRA,DF,Monaco,fr Ligue 1,26-187,1997,5.9,12,6,3,6,3,6,9,66.7,3,7,1,6,3,15,8,0,Matches
2190,Fábio Silva,pt POR,FW,Wolves,eng Premier League,21-199,2002,2.9,7,4,3,4,0,2,3,66.7,1,1,0,1,2,9,0,0,Matches
2191,Rui Silva,pt POR,GK,Betis,es La Liga,29-361,1994,12.5,0,0,0,0,0,0,3,0,3,0,0,0,1,1,5,1,Matches
2192,Thiago Silva,br BRA,DF,Chelsea,eng Premier League,39-134,1984,20.4,23,10,19,3,1,15,26,57.7,11,24,18,6,19,42,102,3,Matches
2193,Marco Silvestri,it ITA,GK,Udinese,it Serie A,32-338,1991,17,0,0,0,0,0,0,3,0,3,1,0,1,0,0,5,3,Matches
2194,Mohamed Simakan,fr FRA,DF,RB Leipzig,de Bundesliga,23-276,2000,17.5,30,18,18,12,0,21,29,72.4,8,27,11,16,23,53,49,0,Matches
2195,Giovanni Simeone,ar ARG,FW,Napoli,it Serie A,28-213,1995,4.4,7,1,1,3,3,2,10,20,8,5,0,5,0,7,4,0,Matches
2196,Giuliano Simeone,ar ARG,"FW,MF",Alavés,es La Liga,21-047,2002,0.3,0,0,0,0,0,0,0,,0,0,0,0,0,0,0,0,Matches
2197,Jan-Carlo Simic,rs SRB,DF,Milan,it Serie A,18-277,2005,1.3,1,1,1,0,0,0,0,,0,4,3,1,0,1,2,0,Matches
2198,Moses Simon,ng NGA,"FW,MF",Nantes,fr Ligue 1,28-206,1995,15.9,6,5,2,4,0,2,6,33.3,4,7,1,6,3,9,5,1,Matches
2199,Unai Simón,es ESP,GK,Athletic Club,es La Liga,26-237,1997,23,2,1,1,1,0,2,3,66.7,1,0,0,0,1,3,9,0,Matches
2200,Xavi Simons,nl NED,MF,RB Leipzig,de Bundesliga,20-288,2003,16,14,6,5,7,2,9,18,50,9,13,0,13,7,21,2,0,Matches
2201,Wilfried Singo,ci CIV,DF,Monaco,fr Ligue 1,23-040,2000,15,18,15,10,8,0,6,11,54.5,5,15,8,7,30,48,48,1,Matches
2202,Luis Sinisterra,co COL,"FW,MF",Bournemouth,eng Premier League,24-231,1999,5,17,7,8,6,3,8,14,57.1,6,11,0,11,7,24,3,0,Matches
2203,Daley Sinkgraven,nl NED,DF,Las Palmas,es La Liga,28-214,1995,2.7,7,4,3,4,0,1,6,16.7,5,2,1,1,3,10,7,0,Matches
2204,Jailson Siqueira,br BRA,"DF,MF",Celta Vigo,es La Liga,28-149,1995,1.4,7,2,6,1,0,4,5,80,1,3,1,2,3,10,7,0,Matches
2205,Ayanda Sishuba,be BEL,"MF,FW",Lens,fr Ligue 1,19-001,2005,0.5,1,0,0,0,1,0,1,0,1,1,0,1,0,1,0,0,Matches
2206,Ibrahima Sissoko,ml MLI,MF,Strasbourg,fr Ligue 1,26-099,1997,9.7,25,16,8,13,4,16,22,72.7,6,9,5,4,9,34,16,0,Matches
2207,Moussa Sissoko,fr FRA,MF,Nantes,fr Ligue 1,34-171,1989,6.8,11,6,4,5,2,6,10,60,4,0,0,0,5,16,14,0,Matches
2208,Antonio Sivera,es ESP,GK,Alavés,es La Liga,27-176,1996,22,0,0,0,0,0,0,1,0,1,0,0,0,0,0,11,0,Matches
2209,Tim Skarke,de GER,"FW,MF",Darmstadt 98,de Bundesliga,27-149,1996,14.7,15,10,9,3,3,7,16,43.8,9,14,1,13,5,20,11,0,Matches
2210,Ellyes Skhiri,tn TUN,MF,Eint Frankfurt,de Bundesliga,28-269,1995,13.5,28,16,10,15,3,12,24,50,12,21,2,19,19,47,29,1,Matches
2211,Oliver Skipp,eng ENG,"MF,FW",Tottenham,eng Premier League,23-140,2000,6.4,15,10,7,5,3,8,13,61.5,5,10,1,9,1,16,6,0,Matches
2212,Leo Skiri Østigård,no NOR,DF,Napoli,it Serie A,24-067,1999,9.7,17,9,10,7,0,3,6,50,3,9,7,2,8,25,37,0,Matches
2213,Łukasz Skorupski,pl POL,GK,Bologna,it Serie A,32-274,1991,19,1,1,1,0,0,1,2,50,1,0,0,0,0,1,6,0,Matches
2214,Robert Skov,dk DEN,"DF,FW",Hoffenheim,de Bundesliga,27-259,1996,9.9,16,9,10,5,1,10,26,38.5,16,15,3,12,8,24,15,1,Matches
2215,Milan Škriniar,sk SVK,DF,Paris S-G,fr Ligue 1,28-357,1995,13.4,20,15,14,6,0,13,19,68.4,6,16,9,7,11,31,33,0,Matches
2216,Naatan Skyttä,fi FIN,"MF,FW",Toulouse,fr Ligue 1,21-272,2002,0.9,2,2,1,0,1,0,0,,0,0,0,0,0,2,0,0,Matches
2217,Chris Smalling,eng ENG,DF,Roma,it Serie A,34-073,1989,2.7,1,1,1,0,0,1,3,33.3,2,1,0,1,4,5,3,0,Matches
2218,Adam Smith,eng ENG,DF,Bournemouth,eng Premier League,32-280,1991,9.3,11,4,7,0,4,5,11,45.5,6,11,6,5,8,19,27,0,Matches
2219,Emile Smith Rowe,eng ENG,MF,Arsenal,eng Premier League,23-190,2000,2.4,3,0,2,1,0,2,4,50,2,3,1,2,1,4,0,0,Matches
2220,Hrvoje Smolčić,hr CRO,DF,Eint Frankfurt,de Bundesliga,23-170,2000,2.8,6,2,6,0,0,4,5,80,1,2,0,2,3,9,19,0,Matches
2221,Danilo Soares,br BRA,DF,Bochum,de Bundesliga,32-097,1991,3.9,10,6,5,3,2,5,8,62.5,3,6,0,6,7,17,11,0,Matches
2222,Eduard Sobol,ua UKR,DF,Strasbourg,fr Ligue 1,28-289,1995,0.3,0,0,0,0,0,0,0,,0,0,0,0,0,0,1,0,Matches
2223,Rubén Sobrino,es ESP,"MF,FW",Cádiz,es La Liga,31-247,1992,8,22,10,7,11,4,10,23,43.5,13,11,1,10,9,31,10,0,Matches
2224,Andrea Sodero,it ITA,MF,Empoli,it Serie A,19-180,2004,0.1,0,0,0,0,0,0,0,,0,0,0,0,0,0,0,0,Matches
2225,Emran Soglo,eng ENG,"MF,DF",Marseille,fr Ligue 1,18-207,2005,1.2,2,1,0,2,0,1,3,33.3,2,6,0,6,1,3,3,0,Matches
2226,Alex Sola,es ESP,"FW,MF",Alavés,es La Liga,24-239,1999,7.4,16,11,6,5,5,7,11,63.6,4,10,1,9,4,20,8,0,Matches
2227,Alex Sola,es ESP,"DF,MF",Real Sociedad,es La Liga,24-239,1999,0.3,0,0,0,0,0,0,0,,0,0,0,0,1,1,2,0,Matches
2228,Dominic Solanke,eng ENG,FW,Bournemouth,eng Premier League,26-142,1997,20.7,11,7,1,6,4,5,9,55.6,4,17,4,13,3,14,27,0,Matches
2229,Ola Solbakken,no NOR,FW,Roma,it Serie A,25-149,1998,0.3,0,0,0,0,0,0,0,,0,0,0,0,0,0,0,0,Matches
2230,Carlos Soler,es ESP,"DF,MF",Paris S-G,fr Ligue 1,27-032,1997,6.8,9,7,3,3,3,4,17,23.5,13,6,3,3,2,11,8,1,Matches
2231,Jhon Solis,co COL,MF,Girona,es La Liga,19-123,2004,1.5,4,2,2,1,1,1,5,20,4,4,1,3,1,5,3,0,Matches
2232,Manor Solomon,il ISR,FW,Tottenham,eng Premier League,24-194,1999,2.2,3,3,1,1,1,1,2,50,1,4,0,4,3,6,2,0,Matches
2233,Yann Sommer,ch SUI,GK,Inter,it Serie A,35-048,1988,21,1,1,1,0,0,1,1,100,0,1,0,1,0,1,4,1,Matches
2234,Brandon Soppy,fr FRA,DF,Torino,it Serie A,21-347,2002,2,2,2,1,1,0,2,6,33.3,4,2,0,2,0,2,3,1,Matches
2235,David Soria,es ESP,GK,Getafe,es La Liga,30-305,1993,22,0,0,0,0,0,0,1,0,1,0,0,0,0,0,9,6,Matches
2236,Alberto Soro,es ESP,MF,Granada,es La Liga,24-331,1999,0.1,0,0,0,0,0,0,0,,0,0,0,0,0,0,0,0,Matches
2237,Alessandro Sorrentino,it ITA,GK,Monza,it Serie A,21-306,2002,3.6,0,0,0,0,0,0,0,,0,0,0,0,0,0,0,0,Matches
2238,Borna Sosa,hr CRO,"FW,DF",Stuttgart,de Bundesliga,26-013,1998,0.5,0,0,0,0,0,0,1,0,1,0,0,0,0,0,0,0,Matches
2239,Hugo Sotelo,es ESP,MF,Celta Vigo,es La Liga,20-046,2003,3.4,8,7,1,5,2,2,7,28.6,5,5,1,4,1,9,2,0,Matches
2240,Florian Sotoca,fr FRA,"MF,DF",Lens,fr Ligue 1,33-101,1990,15.3,16,9,5,10,1,9,20,45,11,17,1,16,6,22,21,0,Matches
2241,Riccardo Sottil,it ITA,FW,Fiorentina,it Serie A,24-245,1999,5.9,7,4,3,1,3,1,5,20,4,7,0,7,1,8,1,0,Matches
2242,Tomáš Souček,cz CZE,MF,West Ham,eng Premier League,28-341,1995,19,28,21,10,16,2,11,25,44,14,32,16,16,22,50,53,0,Matches
2243,Matìas Soulé,ar ARG,"FW,MF",Frosinone,it Serie A,20-294,2003,19.3,27,16,9,12,6,11,27,40.7,16,24,2,22,11,38,5,0,Matches
2244,Boubakary Soumaré,fr FRA,MF,Sevilla,es La Liga,24-341,1999,10.4,15,10,6,9,0,5,7,71.4,2,8,1,7,12,27,11,1,Matches
2245,Issa Soumaré,sn SEN,"FW,MF",Le Havre,fr Ligue 1,23-116,2000,2.6,2,0,2,0,0,0,4,0,4,0,0,0,0,2,2,0,Matches
2246,Vinicius Souza,br BRA,MF,Sheffield Utd,eng Premier League,24-231,1999,18.7,77,46,35,30,12,22,40,55,18,29,5,24,24,101,45,1,Matches
2247,Djibril Sow,ch SUI,MF,Sevilla,es La Liga,26-362,1997,12.1,23,18,12,6,5,8,19,42.1,11,13,0,13,11,34,7,1,Matches
2248,Saidou Sow,gn GUI,DF,Strasbourg,fr Ligue 1,21-214,2002,0.3,1,0,0,1,0,0,0,,0,0,0,0,1,2,4,0,Matches
2249,Çağlar Söyüncü,tr TUR,DF,Atlético Madrid,es La Liga,27-256,1996,1.3,1,1,1,0,0,0,0,,0,1,0,1,1,2,7,0,Matches
2250,Djed Spence,eng ENG,"MF,DF",Genoa,it Serie A,23-178,2000,1.5,2,2,2,0,0,1,1,100,0,3,1,2,2,4,2,0,Matches
2251,Stijn Spierings,nl NED,MF,Toulouse,fr Ligue 1,27-328,1996,10.5,32,25,15,13,4,21,36,58.3,15,14,2,12,20,52,22,0,Matches
2252,Stijn Spierings,nl NED,MF,Lens,fr Ligue 1,27-328,1996,1.3,1,0,0,1,0,1,1,100,0,2,1,1,2,3,1,0,Matches
2253,Leonardo Spinazzola,it ITA,DF,Roma,it Serie A,30-315,1993,11.5,11,4,7,4,0,6,14,42.9,8,6,2,4,3,14,11,0,Matches
2254,Marco Sportiello,it ITA,GK,Milan,it Serie A,31-269,1992,2,0,0,0,0,0,0,0,,0,0,0,0,0,0,1,0,Matches
2255,Anton Stach,de GER,MF,Hoffenheim,de Bundesliga,25-080,1998,14.2,50,30,30,16,4,25,43,58.1,18,15,4,11,45,95,40,0,Matches
2256,Anton Stach,de GER,MF,Mainz 05,de Bundesliga,25-080,1998,1.9,3,0,2,0,1,2,4,50,2,5,0,5,2,5,5,0,Matches
2257,Jens Stage,dk DEN,MF,Werder Bremen,de Bundesliga,27-087,1996,17.8,37,17,17,17,3,12,31,38.7,19,27,15,12,17,54,34,0,Matches
2258,Josip Stanišić,hr CRO,DF,Leverkusen,de Bundesliga,23-307,2000,5.8,14,8,6,7,1,5,9,55.6,4,5,1,4,4,18,8,0,Matches
2259,Carl Starfelt,se SWE,DF,Celta Vigo,es La Liga,28-247,1995,15.9,23,20,18,4,1,11,17,64.7,6,21,17,4,21,44,105,2,Matches
2260,Niklas Stark,de GER,DF,Werder Bremen,de Bundesliga,28-295,1995,9.4,24,14,11,11,2,10,13,76.9,3,11,7,4,12,36,47,1,Matches
2261,Jason Steele,eng ENG,GK,Brighton,eng Premier League,33-169,1990,13,0,0,0,0,0,0,3,0,3,0,0,0,0,0,4,0,Matches
2262,Pascal Stenzel,de GER,DF,Stuttgart,de Bundesliga,27-320,1996,9,14,7,5,8,1,10,26,38.5,16,15,6,9,13,27,21,0,Matches
2263,Leonidas Stergiou,ch SUI,DF,Stuttgart,de Bundesliga,21-337,2002,0.5,5,3,2,3,0,3,3,100,0,1,0,1,1,6,1,0,Matches
2264,Raheem Sterling,eng ENG,"FW,MF",Chelsea,eng Premier League,29-057,1994,17.6,18,9,6,7,5,9,20,45,11,8,0,8,12,30,8,0,Matches
2265,Trivante Stewart,jm JAM,"FW,MF",Salernitana,it Serie A,23-318,2000,1.1,0,0,0,0,0,0,0,,0,1,0,1,0,0,0,0,Matches
2266,Angelo Stiller,de GER,MF,Hoffenheim,de Bundesliga,22-305,2001,0.9,0,0,0,0,0,0,1,0,1,2,0,2,0,0,3,0,Matches
2267,Angelo Stiller,de GER,MF,Stuttgart,de Bundesliga,22-305,2001,16.2,32,20,10,19,3,13,25,52,12,24,8,16,18,50,12,2,Matches
2268,Kevin Stöger,at AUT,MF,Bochum,de Bundesliga,30-160,1993,15.1,28,18,12,13,3,15,40,37.5,25,21,3,18,12,40,6,0,Matches
2269,Filip Stojilković,ch SUI,"FW,MF",Darmstadt 98,de Bundesliga,24-030,2000,1.7,1,1,0,0,1,0,0,,0,0,0,0,0,1,1,0,Matches
2270,John Stones,eng ENG,"DF,MF",Manchester City,eng Premier League,29-251,1994,5.6,2,1,1,0,1,0,3,0,3,9,5,4,3,5,12,0,Matches
2271,Thomas Strakosha,al ALB,GK,Brentford,eng Premier League,28-321,1995,1.5,0,0,0,0,0,0,0,,0,0,0,0,0,0,0,0,Matches
2272,Jørgen Strand Larsen,no NOR,FW,Celta Vigo,es La Liga,23-362,2000,19.5,13,8,1,9,3,5,23,21.7,18,10,1,9,3,16,12,0,Matches
2273,Gabriel Strefezza,br BRA,FW,Lecce,it Serie A,26-291,1997,12.4,24,17,8,7,9,14,20,70,6,17,0,17,7,31,11,0,Matches
2274,Kevin Strootman,nl NED,MF,Genoa,it Serie A,33-355,1990,8.8,28,14,12,13,3,11,22,50,11,13,4,9,3,31,12,0,Matches
2275,Cristhian Stuani,uy URU,FW,Girona,es La Liga,37-114,1986,7.1,12,10,3,6,3,4,7,57.1,3,6,1,5,5,17,10,0,Matches
2276,Álex Suárez,es ESP,DF,Las Palmas,es La Liga,30-322,1993,16.2,36,23,20,14,2,22,25,88,3,18,10,8,11,47,65,0,Matches
2277,Damián Suárez,uy URU,DF,Getafe,es La Liga,35-282,1988,14.4,36,21,16,16,4,26,45,57.8,19,13,3,10,10,46,31,0,Matches
2278,Denis Suárez,es ESP,"MF,FW",Villarreal,es La Liga,30-028,1994,1.5,0,0,0,0,0,0,2,0,2,2,2,0,0,0,4,0,Matches
2279,Gabriel Suazo,cl CHI,DF,Toulouse,fr Ligue 1,26-178,1997,15.6,39,18,23,13,3,21,49,42.9,28,27,3,24,15,54,24,0,Matches
2280,Isaac Success,ng NGA,FW,Udinese,it Serie A,28-027,1996,8.1,5,4,0,4,1,1,2,50,1,3,1,2,1,6,9,0,Matches
2281,Niklas Süle,de GER,DF,Dortmund,de Bundesliga,28-153,1995,9.4,5,5,3,2,0,3,5,60,2,16,8,8,9,14,29,2,Matches
2282,Ibrahim Sulemana,gh GHA,MF,Cagliari,it Serie A,20-257,2003,9.5,21,9,6,12,3,10,18,55.6,8,20,3,17,5,26,11,0,Matches
2283,Tomáš Suslov,sk SVK,"MF,FW",Hellas Verona,it Serie A,21-241,2002,12.9,19,11,6,9,4,8,22,36.4,14,10,0,10,3,22,3,0,Matches
2284,Suso,es ESP,"MF,FW",Sevilla,es La Liga,30-076,1993,12.1,16,12,9,7,0,5,12,41.7,7,6,0,6,3,19,2,0,Matches
2285,Mattias Svanberg,se SWE,MF,Wolfsburg,de Bundesliga,25-029,1999,14.6,30,13,6,15,9,9,30,30,21,18,4,14,17,47,21,0,Matches
2286,Mile Svilar,rs SRB,GK,Roma,it Serie A,24-160,1999,1,0,0,0,0,0,0,0,,0,0,0,0,0,0,0,0,Matches
2287,Williot Swedberg,se SWE,"MF,FW",Celta Vigo,es La Liga,20-002,2004,1,5,3,2,3,0,3,5,60,2,0,0,0,0,5,2,0,Matches
2288,Abakar Sylla,ci CIV,DF,Strasbourg,fr Ligue 1,21-040,2002,11.6,41,17,24,13,4,24,29,82.8,5,23,5,18,17,58,47,1,Matches
2289,Dembo Sylla,gn GUI,DF,Lorient,fr Ligue 1,21-085,2002,0.5,1,1,0,1,0,0,0,,0,0,0,0,1,2,2,0,Matches
2290,Issiaga Sylla,gn GUI,DF,Montpellier,fr Ligue 1,30-033,1994,8,15,9,9,4,2,8,18,44.4,10,5,1,4,11,26,20,0,Matches
2291,Mamadou Sylla,sn SEN,"FW,MF",Alavés,es La Liga,29-320,1994,0.2,0,0,0,0,0,0,0,,0,1,1,0,0,0,1,0,Matches
2292,Attila Szalai,hu HUN,DF,Hoffenheim,de Bundesliga,26-014,1998,3.2,3,1,3,0,0,1,4,25,3,6,2,4,1,4,7,0,Matches
2293,Attila Szalai,hu HUN,DF,Freiburg,de Bundesliga,26-014,1998,0.2,0,0,0,0,0,0,1,0,1,3,1,2,0,0,0,1,Matches
2294,Wojciech Szczęsny,pl POL,GK,Juventus,it Serie A,33-291,1990,20,0,0,0,0,0,0,0,,0,0,0,0,0,0,8,1,Matches
2295,Dominik Szoboszlai,hu HUN,MF,Liverpool,eng Premier League,23-101,2000,18.4,29,18,10,11,8,15,44,34.1,29,32,2,30,11,40,16,1,Matches
2296,Przemysław Szymiński,pl POL,MF,Frosinone,it Serie A,29-224,1994,0.1,0,0,0,0,0,0,0,,0,1,1,0,0,0,0,0,Matches
2297,Alexander Sørloth,no NOR,FW,Villarreal,es La Liga,28-060,1995,14.9,4,3,0,1,3,2,5,40,3,7,3,4,0,4,17,0,Matches
2298,Musa Al-Taamari,jo JOR,FW,Montpellier,fr Ligue 1,26-238,1997,14.1,16,14,8,3,5,7,16,43.8,9,15,1,14,3,19,5,0,Matches
2299,Nicolás Tagliafico,ar ARG,DF,Lyon,fr Ligue 1,31-156,1992,14.7,38,24,17,17,4,18,32,56.3,14,13,4,9,10,48,23,0,Matches
2300,Jonathan Tah,de GER,DF,Leverkusen,de Bundesliga,27-357,1996,15.5,15,8,8,6,1,4,12,33.3,8,18,15,3,8,23,63,1,Matches
2301,Montassar Talbi,tn TUN,DF,Lorient,fr Ligue 1,25-253,1998,18,27,14,17,9,1,13,21,61.9,8,28,18,10,25,52,78,0,Matches
2302,Adrien Tameze,cm CMR,"DF,MF",Torino,it Serie A,29-364,1994,14.7,18,12,5,11,2,7,20,35,13,16,7,9,35,53,20,1,Matches
2303,Renato Tapia,pe PER,MF,Celta Vigo,es La Liga,28-190,1995,10.1,30,21,13,15,2,8,17,47.1,9,19,4,15,15,45,28,0,Matches
2304,Edmond Tapsoba,bf BFA,DF,Leverkusen,de Bundesliga,25-001,1999,13,17,13,7,9,1,6,9,66.7,3,8,5,3,8,25,35,2,Matches
2305,Matt Targett,eng ENG,DF,Newcastle Utd,eng Premier League,28-138,1995,0.9,2,0,1,1,0,1,1,100,0,1,0,1,0,2,2,0,Matches
2306,Oussama Targhalline,ma MAR,MF,Le Havre,fr Ligue 1,21-259,2002,4.2,6,3,6,0,0,4,7,57.1,3,6,2,4,6,12,6,0,Matches
2307,James Tarkowski,eng ENG,DF,Everton,eng Premier League,31-076,1992,22,31,21,23,8,0,12,23,52.2,11,44,31,13,37,68,102,2,Matches
2308,César Tárrega,es ESP,DF,Valencia,es La Liga,21-342,2002,0.1,0,0,0,0,0,0,0,,0,0,0,0,0,0,2,0,Matches
2309,Nuno Tavares,pt POR,DF,Nott'ham Forest,eng Premier League,24-008,2000,2.1,2,2,2,0,0,2,3,66.7,1,3,0,3,0,2,7,0,Matches
2310,Marcus Tavernier,eng ENG,FW,Bournemouth,eng Premier League,24-318,1999,15,34,22,17,14,3,17,32,53.1,15,18,1,17,4,38,15,0,Matches
2311,Elayis Tavsan,nl NED,"MF,FW",Hellas Verona,it Serie A,22-279,2001,0.3,0,0,0,0,0,0,1,0,1,0,0,0,0,0,1,0,Matches
2312,Charlie Taylor,eng ENG,DF,Burnley,eng Premier League,30-138,1993,16,26,14,13,12,1,12,24,50,12,19,7,12,15,41,53,0,Matches
2313,Loum Tchaouna,fr FRA,"MF,FW",Salernitana,it Serie A,20-148,2003,9.5,9,3,2,6,1,5,12,41.7,7,9,0,9,2,11,11,1,Matches
2314,Jackson Tchatchoua,be BEL,DF,Hellas Verona,it Serie A,22-142,2001,10.4,22,16,17,4,1,13,26,50,13,12,5,7,11,33,32,1,Matches
2315,Enzo Tchato,cm CMR,"DF,MF",Montpellier,fr Ligue 1,21-072,2002,3.6,8,5,7,1,0,3,8,37.5,5,3,2,1,4,12,10,0,Matches
2316,Aurélien Tchouaméni,fr FRA,"MF,DF",Real Madrid,es La Liga,24-007,2000,13,23,14,14,8,1,5,10,50,5,14,8,6,19,42,25,0,Matches
2317,Mathys Tel,fr FRA,"FW,MF",Bayern Munich,de Bundesliga,18-282,2005,3.7,2,0,0,1,1,0,0,,0,7,0,7,3,5,4,0,Matches
2318,Nathan Tella,ng NGA,DF,Leverkusen,de Bundesliga,24-213,1999,1.8,4,2,3,1,0,2,2,100,0,3,0,3,1,5,1,0,Matches
2319,Nahuel Tenaglia,ar ARG,DF,Alavés,es La Liga,27-347,1996,4.5,10,7,9,1,0,6,10,60,4,4,0,4,3,13,28,0,Matches
2320,Arnau Tenas,es ESP,GK,Paris S-G,fr Ligue 1,22-249,2001,2.9,0,0,0,0,0,0,0,,0,0,0,0,0,0,0,0,Matches
2321,Marc-André ter Stegen,de GER,GK,Barcelona,es La Liga,31-279,1992,13,0,0,0,0,0,0,0,,0,0,0,0,0,0,2,1,Matches
2322,Filippo Terracciano,it ITA,DF,Hellas Verona,it Serie A,20-360,2003,14.4,30,19,23,6,1,17,31,54.8,14,24,6,18,20,50,17,0,Matches
2323,Filippo Terracciano,it ITA,FW,Milan,it Serie A,20-360,2003,0,0,0,0,0,0,0,1,0,1,1,0,1,0,0,0,0,Matches
2324,Pietro Terracciano,it ITA,GK,Fiorentina,it Serie A,33-332,1990,20,0,0,0,0,0,0,1,0,1,1,0,1,0,0,5,0,Matches
2325,Ramón Terrats,es ESP,MF,Villarreal,es La Liga,23-108,2000,6.9,9,6,2,6,1,1,8,12.5,7,6,0,6,3,12,4,0,Matches
2326,Martin Terrier,fr FRA,"FW,MF",Rennes,fr Ligue 1,26-336,1997,6.9,4,2,1,2,1,1,6,16.7,5,9,1,8,4,8,8,0,Matches
2327,Kenny Tete,nl NED,DF,Fulham,eng Premier League,28-117,1995,7.4,20,14,14,5,1,9,16,56.3,7,7,3,4,16,36,31,0,Matches
2328,Benjamin Tetteh,gh GHA,"FW,MF",Metz,fr Ligue 1,26-208,1997,2.8,6,6,1,5,0,4,7,57.1,3,0,0,0,0,6,1,0,Matches
2329,Teddy Teuma,mt MLT,MF,Reims,fr Ligue 1,30-126,1993,14.6,35,27,10,16,9,18,38,47.4,20,17,2,15,12,47,4,0,Matches
2330,Florian Thauvin,fr FRA,FW,Udinese,it Serie A,31-008,1993,10.5,5,2,2,2,1,4,12,33.3,8,4,0,4,3,8,1,0,Matches
2331,Arthur Theate,be BEL,DF,Rennes,fr Ligue 1,23-254,2000,15.4,15,9,10,4,1,12,19,63.2,7,23,14,9,22,37,57,1,Matches
2332,Norman Theuerkauf,de GER,"MF,DF",Heidenheim,de Bundesliga,37-010,1987,8.6,16,8,9,5,2,9,15,60,6,11,4,7,10,26,12,0,Matches
2333,Malick Thiaw,de GER,DF,Milan,it Serie A,22-179,2001,10.3,13,11,5,8,0,6,11,54.5,5,16,7,9,7,20,31,0,Matches
2334,Jan Thielmann,de GER,"FW,MF",Köln,de Bundesliga,21-253,2002,7.8,14,8,8,5,1,5,12,41.7,7,21,2,19,4,18,14,0,Matches
2335,Denis Thomalla,de GER,"MF,FW",Heidenheim,de Bundesliga,31-171,1992,3.9,6,4,2,4,0,5,9,55.6,4,2,1,1,3,9,8,0,Matches
2336,Luke Thomas,eng ENG,DF,Sheffield Utd,eng Premier League,22-238,2001,10.2,20,9,13,6,1,8,14,57.1,6,23,5,18,10,30,27,0,Matches
2337,Adrien Thomasson,fr FRA,MF,Lens,fr Ligue 1,30-055,1993,10.2,17,8,4,10,3,8,26,30.8,18,10,0,10,7,24,9,0,Matches
2338,Morten Thorsby,no NOR,MF,Genoa,it Serie A,27-274,1996,7.6,11,7,5,5,1,5,9,55.6,4,13,2,11,4,15,9,0,Matches
2339,Kristian Thorstvedt,no NOR,MF,Sassuolo,it Serie A,24-327,1999,13.1,16,6,3,11,2,7,16,43.8,9,13,5,8,10,26,20,0,Matches
2340,Khéphren Thuram,fr FRA,MF,Nice,fr Ligue 1,22-314,2001,10.8,16,13,3,10,3,9,19,47.4,10,10,4,6,6,22,13,0,Matches
2341,Marcus Thuram,fr FRA,FW,Inter,it Serie A,26-181,1997,17.8,14,10,7,5,2,1,7,14.3,6,16,3,13,4,18,9,0,Matches
2342,Cheikh Tidiane Sabaly,sn SEN,"FW,MF",Metz,fr Ligue 1,24-336,1999,12.3,34,16,19,10,5,15,38,39.5,23,16,2,14,8,42,11,0,Matches
2343,Youri Tielemans,be BEL,"MF,FW",Aston Villa,eng Premier League,26-272,1997,7.3,16,7,7,9,0,7,16,43.8,9,11,0,11,7,23,4,0,Matches
2344,Kieran Tierney,sct SCO,DF,Real Sociedad,es La Liga,26-243,1997,8.7,27,19,12,14,1,14,21,66.7,7,14,5,9,9,36,26,0,Matches
2345,Phillip Tietz,de GER,FW,Augsburg,de Bundesliga,26-209,1997,14.2,10,5,6,3,1,3,8,37.5,5,11,1,10,5,15,24,0,Matches
2346,Steffen Tigges,de GER,"FW,MF",Köln,de Bundesliga,25-187,1998,4.4,2,1,1,0,1,0,0,,0,2,1,1,1,3,4,0,Matches
2347,Antonio Tikvić,hr CRO,DF,Udinese,it Serie A,19-288,2004,0,0,0,0,0,0,0,0,,0,0,0,0,0,0,0,0,Matches
2348,Jurriën Timber,nl NED,DF,Arsenal,eng Premier League,22-231,2001,0.5,1,1,0,1,0,0,0,,0,0,0,0,0,1,1,0,Matches
2349,Jean-Clair Todibo,fr FRA,DF,Nice,fr Ligue 1,24-035,1999,14.6,31,14,15,11,5,19,35,54.3,16,22,9,13,19,50,49,0,Matches
2350,Harry Toffolo,eng ENG,DF,Nott'ham Forest,eng Premier League,28-168,1995,11.2,18,8,14,4,0,10,16,62.5,6,21,9,12,11,29,34,0,Matches
2351,Umut Tohumcu,de GER,MF,Hoffenheim,de Bundesliga,19-176,2004,3,7,5,6,1,0,5,9,55.6,4,7,1,6,1,8,5,0,Matches
2352,Corentin Tolisso,fr FRA,MF,Lyon,fr Ligue 1,29-184,1994,11.6,23,15,6,9,8,10,24,41.7,14,15,3,12,7,30,11,0,Matches
2353,Jeremy Toljan,de GER,DF,Sassuolo,it Serie A,29-179,1994,17.9,10,7,6,3,1,7,13,53.8,6,16,4,12,10,20,41,1,Matches
2354,Rafael Tolói,it ITA,DF,Atalanta,it Serie A,33-116,1990,4.8,6,2,3,1,2,3,6,50,3,1,0,1,7,13,15,0,Matches
2355,Raúl de Tomás,es ESP,FW,Rayo Vallecano,es La Liga,29-109,1994,9,7,3,3,2,2,2,5,40,3,1,0,1,1,8,5,0,Matches
2356,Tiago Tomás,pt POR,"FW,MF",Wolfsburg,de Bundesliga,21-232,2002,7.4,4,1,3,0,1,1,5,20,4,10,0,10,2,6,6,0,Matches
2357,Takehiro Tomiyasu,jp JPN,DF,Arsenal,eng Premier League,25-090,1998,7,11,5,9,2,0,6,9,66.7,3,3,1,2,10,21,19,0,Matches
2358,James Tomkins,eng ENG,DF,Crystal Palace,eng Premier League,34-311,1989,0.1,0,0,0,0,0,0,0,,0,0,0,0,1,1,0,0,Matches
2359,Fikayo Tomori,eng ENG,DF,Milan,it Serie A,26-046,1997,15.4,30,19,22,6,2,15,24,62.5,9,23,16,7,19,49,50,1,Matches
2360,Sandro Tonali,it ITA,MF,Newcastle Utd,eng Premier League,23-271,2000,4.9,7,7,4,2,1,3,9,33.3,6,3,0,3,2,9,4,0,Matches
2361,Ivan Toney,eng ENG,FW,Brentford,eng Premier League,27-324,1996,2,4,2,0,1,3,1,3,33.3,2,0,0,0,1,5,4,0,Matches
2362,Pablo Torre,es ESP,"MF,FW",Girona,es La Liga,20-306,2003,4.9,3,0,0,3,0,2,8,25,6,7,2,5,3,6,5,1,Matches
2363,Raúl Torrente,es ESP,DF,Granada,es La Liga,22-145,2001,11.5,24,15,17,7,0,16,20,80,4,13,8,5,9,33,51,2,Matches
2364,Ferrán Torres,es ESP,FW,Barcelona,es La Liga,23-339,2000,10.4,7,5,1,4,2,5,14,35.7,9,5,0,5,3,10,4,0,Matches
2365,Óliver Torres,es ESP,MF,Sevilla,es La Liga,29-085,1994,9.7,18,9,9,6,3,10,30,33.3,20,19,1,18,1,19,2,0,Matches
2366,Pau Torres,es ESP,DF,Aston Villa,eng Premier League,27-018,1997,16.9,17,10,10,6,1,9,20,45,11,15,6,9,8,25,39,0,Matches
2367,Lucas Torró,es ESP,MF,Osasuna,es La Liga,29-199,1994,12.3,14,9,6,5,3,5,16,31.3,11,4,1,3,23,37,23,0,Matches
2368,Fabio Torsiello,it ITA,"FW,DF",Darmstadt 98,de Bundesliga,19-001,2005,0.3,0,0,0,0,0,0,4,0,4,1,0,1,0,0,0,0,Matches
2369,Ahmed Touba,dz ALG,DF,Lecce,it Serie A,25-328,1998,2.3,4,3,2,2,0,2,2,100,0,4,3,1,4,8,15,0,Matches
2370,Abdoulaye Touré,gn GUI,MF,Le Havre,fr Ligue 1,29-337,1994,14,29,20,15,12,2,19,38,50,19,17,4,13,15,44,16,0,Matches
2371,Souleymane Touré,fr FRA,DF,Lorient,fr Ligue 1,20-312,2003,12,17,8,11,6,0,6,9,66.7,3,21,14,7,24,41,55,1,Matches
2372,Lucas Tousart,fr FRA,MF,Union Berlin,de Bundesliga,26-280,1997,5.4,10,6,4,5,1,5,10,50,5,7,3,4,2,12,9,0,Matches
2373,Andros Townsend,eng ENG,"MF,FW",Luton Town,eng Premier League,32-202,1991,7.8,14,11,6,1,7,10,18,55.6,8,10,0,10,4,18,4,0,Matches
2374,James Trafford,eng ENG,GK,Burnley,eng Premier League,21-116,2002,22,2,1,2,0,0,2,2,100,0,0,0,0,1,3,15,1,Matches
2375,Adama Traoré,es ESP,"FW,DF",Fulham,eng Premier League,28-009,1996,0.5,0,0,0,0,0,0,1,0,1,0,0,0,0,0,1,0,Matches
2376,Bertrand Traoré,bf BFA,"DF,FW",Aston Villa,eng Premier League,28-150,1995,0.1,1,1,1,0,0,0,0,,0,0,0,0,0,1,1,0,Matches
2377,Boubacar Traoré,ml MLI,MF,Wolves,eng Premier League,22-167,2001,4.3,13,10,7,5,1,3,8,37.5,5,7,1,6,3,16,4,0,Matches
2378,Chaka Traorè,ci CIV,FW,Milan,it Serie A,19-042,2004,0.2,2,1,2,0,0,1,2,50,1,1,1,0,0,2,0,0,Matches
2379,Hamari Traoré,ml MLI,DF,Real Sociedad,es La Liga,32-007,1992,16.4,30,15,17,11,2,17,32,53.1,15,14,4,10,14,44,35,0,Matches
2380,Ismaël Traoré,ci CIV,DF,Metz,fr Ligue 1,37-169,1986,15,11,8,6,5,0,6,15,40,9,23,13,10,19,30,54,0,Matches
2381,Omar Traoré,de GER,DF,Heidenheim,de Bundesliga,25-364,1998,15.3,36,21,22,10,4,18,31,58.1,13,15,3,12,22,58,28,1,Matches
2382,Kevin Trapp,de GER,GK,Eint Frankfurt,de Bundesliga,33-210,1990,18,0,0,0,0,0,0,0,,0,0,0,0,1,1,9,1,Matches
2383,Óscar Trejo,ar ARG,"FW,MF",Rayo Vallecano,es La Liga,35-283,1988,9.1,19,11,8,6,5,9,13,69.2,4,9,1,8,3,22,7,0,Matches
2384,Mike Trésor,be BEL,"FW,MF",Burnley,eng Premier League,24-251,1999,4.5,10,6,9,1,0,8,17,47.1,9,5,0,5,1,11,1,0,Matches
2385,Manu Trigueros,es ESP,MF,Villarreal,es La Liga,32-109,1991,2,5,4,5,0,0,2,5,40,3,1,1,0,2,7,5,0,Matches
2386,Christopher Trimmel,at AUT,"DF,MF",Union Berlin,de Bundesliga,36-344,1987,10.4,11,9,4,7,0,6,16,37.5,10,7,1,6,9,20,27,0,Matches
2387,Kieran Trippier,eng ENG,DF,Newcastle Utd,eng Premier League,33-137,1990,19.5,44,21,25,11,8,29,62,46.8,33,32,8,24,22,66,43,3,Matches
2388,Leandro Trossard,be BEL,"FW,MF",Arsenal,eng Premier League,29-061,1994,8.3,11,6,4,5,2,4,10,40,6,15,0,15,6,17,2,0,Matches
2389,Adrien Truffert,fr FRA,DF,Rennes,fr Ligue 1,22-075,2001,14.2,26,16,15,6,5,16,23,69.6,7,17,3,14,10,36,28,0,Matches
2390,Auston Trusty,us USA,DF,Sheffield Utd,eng Premier League,25-175,1998,15,35,23,22,10,3,14,27,51.9,13,19,12,7,13,48,80,2,Matches
2391,Kostas Tsimikas,gr GRE,DF,Liverpool,eng Premier League,27-267,1996,7.4,19,13,9,6,4,9,15,60,6,9,1,8,6,25,10,0,Matches
2392,Viktor Tsyhankov,ua UKR,"MF,DF",Girona,es La Liga,26-080,1997,12.6,15,10,5,5,5,10,18,55.6,8,10,0,10,4,19,12,0,Matches
2393,Stefano Turati,it ITA,GK,Frosinone,it Serie A,22-151,2001,21,0,0,0,0,0,0,0,,0,0,0,0,0,0,6,2,Matches
2394,Matt Turner,us USA,GK,Nott'ham Forest,eng Premier League,29-224,1994,17,0,0,0,0,0,0,0,,0,0,0,0,0,0,8,4,Matches
2395,Beñat Turrientes,es ESP,MF,Real Sociedad,es La Liga,22-003,2002,8.3,13,8,4,7,2,5,12,41.7,7,6,2,4,2,15,8,0,Matches
2396,Tuta,br BRA,DF,Eint Frankfurt,de Bundesliga,24-214,1999,17,38,21,23,11,4,26,38,68.4,12,13,6,7,24,62,68,0,Matches
2397,Destiny Udogie,it ITA,DF,Tottenham,eng Premier League,21-067,2002,17.7,50,26,32,10,8,18,34,52.9,16,20,6,14,25,75,57,4,Matches
2398,Matthieu Udol,fr FRA,DF,Metz,fr Ligue 1,27-320,1996,17,25,18,18,4,3,16,25,64,9,36,11,25,26,51,63,0,Matches
2399,Manuel Ugarte Ribeiro,uy URU,MF,Paris S-G,fr Ligue 1,22-298,2001,12.8,52,32,14,28,10,23,54,42.6,31,13,3,10,23,75,15,1,Matches
2400,Lesley Ugochukwu,fr FRA,MF,Chelsea,eng Premier League,19-314,2004,3,12,9,3,8,1,3,8,37.5,5,5,2,3,1,13,3,0,Matches
2401,Lukas Ullrich,de GER,DF,M'Gladbach,de Bundesliga,19-324,2004,0.2,1,0,1,0,0,1,3,33.3,2,0,0,0,0,1,1,0,Matches
2402,Sven Ulreich,de GER,GK,Bayern Munich,de Bundesliga,35-184,1988,8,1,0,1,0,0,1,1,100,0,0,0,0,0,1,3,2,Matches
2403,Samuel Umtiti,fr FRA,DF,Lille,fr Ligue 1,30-081,1993,2.1,1,1,0,1,0,1,4,25,3,0,0,0,2,3,4,0,Matches
2404,Enes Ünal,tr TUR,"FW,MF",Getafe,es La Liga,26-269,1997,1.6,0,0,0,0,0,0,0,,0,1,0,1,0,0,2,0,Matches
2405,Deniz Undav,de GER,FW,Stuttgart,de Bundesliga,27-199,1996,11.6,16,5,4,5,7,3,8,37.5,5,8,0,8,4,20,4,0,Matches
2406,Dayot Upamecano,fr FRA,DF,Bayern Munich,de Bundesliga,25-099,1998,14.2,26,15,15,10,1,13,24,54.2,11,10,4,6,12,38,38,1,Matches
2407,Kacper Urbanski,pl POL,FW,Bologna,it Serie A,19-149,2004,4.4,7,3,1,6,0,3,5,60,2,7,0,7,2,9,6,0,Matches
2408,Mark Uth,de GER,"MF,FW",Köln,de Bundesliga,32-163,1991,2.9,6,3,2,3,1,2,9,22.2,7,5,0,5,1,7,1,0,Matches
2409,Myrto Uzuni,al ALB,"FW,MF",Granada,es La Liga,28-248,1995,18.1,11,9,3,6,2,5,23,21.7,18,14,2,12,1,12,5,0,Matches
2410,Josha Vagnoman,de GER,"DF,FW",Stuttgart,de Bundesliga,23-054,2000,5.8,9,5,3,6,0,5,14,35.7,9,6,3,3,1,10,7,0,Matches
2411,Óscar Valentín,es ESP,MF,Rayo Vallecano,es La Liga,29-167,1994,18.6,62,38,25,33,4,25,54,46.3,29,38,8,30,19,81,30,1,Matches
2412,Martin Valjent,sk SVK,DF,Mallorca,es La Liga,28-054,1995,17.9,25,15,16,8,1,13,21,61.9,8,22,10,12,23,48,73,1,Matches
2413,Jesús Vallejo,es ESP,DF,Granada,es La Liga,27-029,1997,1.2,3,1,1,2,0,2,2,100,0,3,2,1,0,3,1,1,Matches
2414,Álvaro Vallés,es ESP,GK,Las Palmas,es La Liga,26-193,1997,22,2,1,2,0,0,2,6,33.3,4,0,0,0,0,2,33,1,Matches
2415,Federico Valverde,uy URU,MF,Real Madrid,es La Liga,25-196,1998,19.5,30,21,14,10,6,16,24,66.7,8,19,2,17,28,58,21,0,Matches
2416,Kévin Van Den Kerkhof,dz ALG,FW,Metz,fr Ligue 1,27-326,1996,9.8,22,16,8,9,5,9,21,42.9,12,10,2,8,4,26,13,1,Matches
2417,Siebe Van Der Heyden,be BEL,DF,Mallorca,es La Liga,25-249,1998,3.2,9,2,7,2,0,4,6,66.7,2,1,1,0,7,16,12,0,Matches
2418,Virgil van Dijk,nl NED,DF,Liverpool,eng Premier League,32-210,1991,19.3,26,13,16,7,3,8,8,100,0,29,21,8,26,52,87,0,Matches
2419,Vanderson,br BRA,DF,Monaco,fr Ligue 1,22-227,2001,12,40,26,14,17,9,19,46,41.3,27,19,1,18,20,60,21,1,Matches
2420,Raphaël Varane,fr FRA,DF,Manchester Utd,eng Premier League,30-284,1993,8.8,11,6,4,6,1,5,8,62.5,3,8,6,2,9,20,54,0,Matches
2421,Ruben Vargas,ch SUI,"MF,FW",Augsburg,de Bundesliga,25-182,1998,10.6,8,3,2,4,2,5,13,38.5,8,11,3,8,3,11,11,0,Matches
2422,Johan Vásquez,mx MEX,DF,Genoa,it Serie A,25-104,1998,17.3,33,20,27,6,0,26,35,74.3,9,29,10,19,27,60,61,0,Matches
2423,José Luis García Vayá,es ESP,MF,Valencia,es La Liga,25-176,1998,21.7,49,34,21,23,5,24,44,54.5,20,25,7,18,26,75,42,0,Matches
2424,Jesus Vazquez,es ESP,"DF,MF",Valencia,es La Liga,21-032,2003,2.7,7,2,5,1,1,4,5,80,1,5,0,5,0,7,4,0,Matches
2425,Kevin Vázquez,es ESP,DF,Celta Vigo,es La Liga,30-317,1993,6.9,15,13,7,7,1,12,18,66.7,6,11,3,8,4,19,25,0,Matches
2426,Lucas Vázquez,es ESP,DF,Real Madrid,es La Liga,32-217,1991,6.4,14,11,9,5,0,5,7,71.4,2,11,1,10,6,20,16,0,Matches
2427,Matías Vecino,uy URU,MF,Lazio,it Serie A,32-163,1991,4.7,7,5,1,6,0,3,8,37.5,5,7,3,4,4,11,6,0,Matches
2428,Gabriel Veiga,es ESP,FW,Celta Vigo,es La Liga,21-252,2002,0.2,0,0,0,0,0,0,0,,0,0,0,0,0,0,0,0,Matches
2429,Alejo Véliz,ar ARG,FW,Tottenham,eng Premier League,20-137,2003,0.6,1,0,1,0,0,0,0,,0,0,0,0,0,1,0,0,Matches
2430,Miloš Veljković,rs SRB,DF,Werder Bremen,de Bundesliga,28-130,1995,12.2,18,9,9,8,1,11,20,55,9,15,10,5,5,23,30,0,Matches
2431,Joël Veltman,nl NED,DF,Brighton,eng Premier League,32-019,1992,10.2,27,22,13,11,3,17,28,60.7,11,12,6,6,12,39,32,1,Matches
2432,Micky van de Ven,nl NED,DF,Tottenham,eng Premier League,22-290,2001,12.5,21,13,14,5,2,10,14,71.4,4,9,6,3,5,26,40,0,Matches
2433,Lorenzo Venuti,it ITA,"DF,FW",Lecce,it Serie A,28-297,1995,1.3,1,1,1,0,0,1,1,100,0,3,2,1,2,3,5,0,Matches
2434,Bart Verbruggen,nl NED,GK,Brighton,eng Premier League,21-169,2002,9,1,1,1,0,0,1,1,100,0,0,0,0,0,1,2,2,Matches
2435,Simone Verdi,it ITA,FW,Torino,it Serie A,31-206,1992,0,0,0,0,0,0,0,0,,0,0,0,0,0,0,0,0,Matches
2436,Jordan Veretout,fr FRA,MF,Marseille,fr Ligue 1,30-339,1993,14.6,26,16,15,8,3,12,24,50,12,16,4,12,8,34,19,0,Matches
2437,Arthur Vermeeren,be BEL,MF,Atlético Madrid,es La Liga,18-361,2005,0.5,1,0,0,1,0,0,0,,0,3,0,3,2,3,0,0,Matches
2438,Mikel Vesga,es ESP,MF,Athletic Club,es La Liga,30-258,1993,12.2,25,12,6,17,2,12,33,36.4,21,11,3,8,19,44,23,1,Matches
2439,Guglielmo Vicario,it ITA,GK,Tottenham,eng Premier League,27-119,1996,22,0,0,0,0,0,0,1,0,1,0,0,0,0,0,20,2,Matches
2440,Carlos Vicente,es ESP,"FW,MF",Alavés,es La Liga,24-286,1999,3.2,6,2,3,3,0,5,8,62.5,3,0,0,0,1,7,2,0,Matches
2441,Nacho Vidal,es ESP,"DF,FW",Osasuna,es La Liga,29-010,1995,1.1,5,4,2,2,1,2,5,40,3,2,0,2,0,5,6,0,Matches
2442,Nacho Vidal,es ESP,DF,Mallorca,es La Liga,29-010,1995,0.4,1,1,1,0,0,1,1,100,0,1,0,1,0,1,1,0,Matches
2443,Fabio Vieira,pt POR,MF,Arsenal,eng Premier League,23-249,2000,2.7,3,2,2,0,1,3,3,100,0,0,0,0,2,5,1,0,Matches
2444,Jonathan Viera,es ESP,"MF,FW",Las Palmas,es La Liga,34-105,1989,6.9,6,3,1,2,3,1,9,11.1,8,0,0,0,0,6,1,0,Matches
2445,Samuele Vignato,it ITA,"MF,FW",Monza,it Serie A,19-344,2004,3.8,6,4,2,3,1,2,3,66.7,1,2,0,2,1,7,1,0,Matches
2446,Oscar Vilhelmsson,se SWE,"FW,MF",Darmstadt 98,de Bundesliga,20-124,2003,5.8,7,3,0,4,3,3,3,100,0,7,2,5,1,8,4,0,Matches
2447,Asier Villalibre,es ESP,FW,Athletic Club,es La Liga,26-126,1997,3.1,1,1,0,0,1,1,1,100,0,1,0,1,0,1,4,0,Matches
2448,Gonzalo Villar,es ESP,MF,Granada,es La Liga,25-317,1998,13.3,36,23,18,14,4,17,28,60.7,11,25,8,17,5,41,19,0,Matches
2449,Iván Villar,es ESP,GK,Celta Vigo,es La Liga,26-209,1997,9.3,0,0,0,0,0,0,1,0,1,0,0,0,0,0,5,0,Matches
2450,Matías Viña,uy URU,DF,Sassuolo,it Serie A,26-086,1997,11.3,34,21,22,7,5,20,36,55.6,16,12,2,10,9,43,34,0,Matches
2451,Rúben Vinagre,pt POR,DF,Hellas Verona,it Serie A,24-300,1999,0,0,0,0,0,0,0,0,,0,0,0,0,0,0,0,0,Matches
2452,Carlos Vinícius,br BRA,FW,Fulham,eng Premier League,28-315,1995,3.5,3,2,0,1,2,0,4,0,4,4,0,4,0,3,1,0,Matches
2453,Nicolas Viola,it ITA,"MF,FW",Cagliari,it Serie A,34-114,1989,9.8,9,7,2,5,2,5,13,38.5,8,6,0,6,2,11,5,0,Matches
2454,Alan Virginius,fr FRA,FW,Lille,fr Ligue 1,21-031,2003,0.8,1,1,1,0,0,0,1,0,1,0,0,0,0,1,0,0,Matches
2455,Alan Virginius,fr FRA,MF,Clermont Foot,fr Ligue 1,21-031,2003,0.8,0,0,0,0,0,0,0,,0,1,0,1,0,0,1,0,Matches
2456,Ricardo Visus,es ESP,DF,Betis,es La Liga,22-285,2001,0.8,,0,,,,,,,,,,,1,,,,Matches
2457,Mattia Viti,it ITA,DF,Sassuolo,it Serie A,22-010,2002,3.9,4,1,1,2,1,1,5,20,4,8,5,3,4,8,17,0,Matches
2458,Vitinha,pt POR,FW,Marseille,fr Ligue 1,23-325,2000,10.3,14,8,3,5,6,3,12,25,9,11,2,9,5,19,8,0,Matches
2459,Vitinha,pt POR,MF,Paris S-G,fr Ligue 1,23-355,2000,15.3,26,15,8,9,9,14,32,43.8,18,19,4,15,16,42,15,2,Matches
2460,Vitinho,br BRA,DF,Burnley,eng Premier League,24-195,1999,14.6,42,19,25,13,4,29,58,50,29,19,1,18,9,51,27,3,Matches
2461,Daniel Vivian,es ESP,DF,Athletic Club,es La Liga,24-203,1999,21.7,30,21,24,6,0,19,29,65.5,10,35,15,20,15,45,70,0,Matches
2462,Odisseas Vlachodimos,gr GRE,GK,Nott'ham Forest,eng Premier League,29-283,1994,5,0,0,0,0,0,0,1,0,1,0,0,0,0,0,1,0,Matches
2463,Dušan Vlahović,rs SRB,FW,Juventus,it Serie A,24-006,2000,14.7,4,3,0,3,1,1,4,25,3,0,0,0,1,5,10,0,Matches
2464,Nikola Vlašić,hr CRO,MF,Torino,it Serie A,26-122,1997,16.3,19,11,3,10,6,3,18,16.7,15,11,2,9,3,22,11,0,Matches
2465,Alessandro Vogliacco,it ITA,DF,Genoa,it Serie A,25-142,1998,4.9,8,6,4,3,1,5,6,83.3,1,4,2,2,12,20,13,1,Matches
2466,Kevin Vogt,de GER,DF,Hoffenheim,de Bundesliga,32-133,1991,14.7,14,10,7,7,0,8,13,61.5,5,16,13,3,9,23,54,0,Matches
2467,Kevin Vogt,de GER,DF,Union Berlin,de Bundesliga,32-133,1991,3,2,2,2,0,0,2,3,66.7,1,3,3,0,1,3,17,1,Matches
2468,Mërgim Vojvoda,xk KVX,DF,Torino,it Serie A,29-002,1995,8.5,4,3,1,2,1,3,8,37.5,5,7,0,7,7,11,13,0,Matches
2469,Kevin Volland,de GER,"MF,FW",Union Berlin,de Bundesliga,31-188,1992,6.8,14,6,4,4,6,4,11,36.4,7,3,0,3,3,17,4,0,Matches
2470,Cristian Volpato,it ITA,"MF,FW",Sassuolo,it Serie A,20-080,2003,2.3,5,4,3,2,0,2,6,33.3,4,3,0,3,1,6,2,0,Matches
2471,Aster Vranckx,be BEL,MF,Wolfsburg,de Bundesliga,21-122,2002,8.8,24,10,9,6,9,13,22,59.1,9,11,5,6,10,34,22,0,Matches
2472,Stefan de Vrij,nl NED,DF,Inter,it Serie A,31-363,1992,10.3,12,8,8,4,0,3,8,37.5,5,14,6,8,12,24,29,0,Matches
2473,Elye Wahi,fr FRA,FW,Montpellier,fr Ligue 1,21-032,2003,0.2,0,0,0,0,0,0,0,,0,0,0,0,0,0,0,0,Matches
2474,Elye Wahi,fr FRA,FW,Lens,fr Ligue 1,21-032,2003,8.4,3,1,1,2,0,1,6,16.7,5,1,0,1,1,4,1,0,Matches
2475,Walace,br BRA,MF,Udinese,it Serie A,28-305,1995,21,37,24,22,15,0,19,44,43.2,25,26,4,22,28,65,39,1,Matches
2476,Luca Waldschmidt,de GER,"MF,FW",Köln,de Bundesliga,27-260,1996,9.4,16,9,2,11,3,5,14,35.7,9,14,3,11,5,21,8,0,Matches
2477,Kyle Walker,eng ENG,DF,Manchester City,eng Premier League,33-251,1990,19.7,23,14,13,9,1,12,24,50,12,13,4,9,16,39,26,1,Matches
2478,Sebastian Walukiewicz,pl POL,DF,Empoli,it Serie A,23-304,2000,11.8,23,15,21,2,0,16,21,76.2,5,23,12,11,9,32,68,0,Matches
2479,Aaron Wan-Bissaka,eng ENG,DF,Manchester Utd,eng Premier League,26-069,1997,9.8,25,19,12,11,2,16,22,72.7,6,14,8,6,20,45,38,1,Matches
2480,Joel Ward,eng ENG,DF,Crystal Palace,eng Premier League,34-097,1989,14.8,33,20,18,14,1,22,37,59.5,15,11,6,5,8,41,55,1,Matches
2481,James Ward-Prowse,eng ENG,MF,West Ham,eng Premier League,29-094,1994,20.7,26,18,10,14,2,10,26,38.5,16,21,7,14,27,53,34,0,Matches
2482,Deivid Washington,br BRA,DF,Chelsea,eng Premier League,18-243,2005,0.1,1,1,1,0,0,0,1,0,1,0,0,0,0,1,0,0,Matches
2483,Ollie Watkins,eng ENG,FW,Aston Villa,eng Premier League,28-035,1995,21.5,7,5,0,2,5,2,7,28.6,5,16,2,14,3,10,14,0,Matches
2484,Timothy Weah,us USA,"DF,FW",Juventus,it Serie A,23-346,2000,8.1,17,14,8,7,2,9,13,69.2,4,8,1,7,3,20,12,0,Matches
2485,Adam Webster,eng ENG,DF,Brighton,eng Premier League,29-030,1995,7,10,10,7,2,1,5,14,35.7,9,6,3,3,6,16,29,1,Matches
2486,Wout Weghorst,nl NED,FW,Hoffenheim,de Bundesliga,31-180,1992,13.6,8,5,3,4,1,5,8,62.5,3,15,4,11,1,9,14,0,Matches
2487,Julian Weigl,de GER,MF,M'Gladbach,de Bundesliga,28-148,1995,16.9,34,22,18,14,2,18,31,58.1,13,26,6,20,23,57,38,1,Matches
2488,Nelson Weiper,de GER,"FW,MF",Mainz 05,de Bundesliga,18-323,2005,1.2,1,0,1,0,0,1,2,50,1,1,0,1,1,2,0,0,Matches
2489,Mitchell Weiser,de GER,"DF,FW",Werder Bremen,de Bundesliga,29-288,1994,17.4,40,23,20,17,3,19,32,59.4,13,25,4,21,7,47,23,0,Matches
2490,Noah Weißhaupt,de GER,"DF,FW",Freiburg,de Bundesliga,22-136,2001,7,6,2,3,0,3,2,7,28.6,5,7,0,7,8,14,10,0,Matches
2491,Shon Weissman,il ISR,FW,Granada,es La Liga,27-354,1996,0.9,1,1,0,0,1,1,4,25,3,3,0,3,0,1,1,0,Matches
2492,Danny Welbeck,eng ENG,"FW,MF",Brighton,eng Premier League,33-069,1990,8.4,13,5,4,7,2,4,8,50,4,7,0,7,3,16,10,1,Matches
2493,Timo Werner,de GER,FW,Tottenham,eng Premier League,27-334,1996,1.9,2,0,1,1,0,2,6,33.3,4,1,0,1,0,2,0,0,Matches
2494,Timo Werner,de GER,"FW,MF",RB Leipzig,de Bundesliga,27-334,1996,2.3,2,1,0,1,1,0,0,,0,1,0,1,1,3,0,0,Matches
2495,Ben White,eng ENG,DF,Arsenal,eng Premier League,26-118,1997,18.4,25,14,11,12,2,12,24,50,12,23,14,9,19,44,41,1,Matches
2496,Silvan Widmer,ch SUI,"DF,FW",Mainz 05,de Bundesliga,30-335,1993,5.9,10,7,7,2,1,8,17,47.1,9,6,1,5,7,17,14,0,Matches
2497,Mateusz Wieteska,pl POL,DF,Cagliari,it Serie A,26-357,1997,7.3,8,7,5,1,2,1,6,16.7,5,8,3,5,12,20,31,0,Matches
2498,Mateusz Wieteska,pl POL,DF,Clermont Foot,fr Ligue 1,26-357,1997,1.9,4,1,3,1,0,3,5,60,2,4,2,2,5,9,8,0,Matches
2499,Iñaki Williams,gh GHA,FW,Athletic Club,es La Liga,29-233,1994,19.3,16,10,4,6,6,10,19,52.6,9,26,4,22,9,25,18,0,Matches
2500,Neco Williams,wls WAL,"DF,FW",Nott'ham Forest,eng Premier League,22-296,2001,6,36,22,23,8,5,21,32,65.6,11,18,5,13,11,47,22,0,Matches
2501,Nico Williams,es ESP,FW,Athletic Club,es La Liga,21-206,2002,16.6,23,9,9,8,6,10,27,37,17,13,2,11,3,26,4,0,Matches
2502,Willian,br BRA,FW,Fulham,eng Premier League,35-178,1988,14,7,3,3,2,2,2,13,15.4,11,11,0,11,6,13,8,0,Matches
2503,Joe Willock,eng ENG,"MF,FW",Newcastle Utd,eng Premier League,24-167,1999,1.5,3,2,2,1,0,2,5,40,3,2,0,2,0,3,1,0,Matches
2504,Callum Wilson,eng ENG,FW,Newcastle Utd,eng Premier League,31-341,1992,8.1,4,3,0,2,2,0,4,0,4,5,0,5,1,5,1,0,Matches
2505,Harry Wilson,wls WAL,FW,Fulham,eng Premier League,26-318,1997,12.3,16,10,6,7,3,8,17,47.1,9,20,3,17,8,24,4,0,Matches
2506,Josh Wilson-Esbrand,eng ENG,"DF,MF",Reims,fr Ligue 1,21-039,2002,5.1,5,4,2,3,0,2,8,25,6,5,2,3,6,11,7,0,Matches
2507,Patrick Wimmer,at AUT,FW,Wolfsburg,de Bundesliga,22-249,2001,3.1,7,3,5,2,0,6,7,85.7,1,8,0,8,2,9,3,0,Matches
2508,Jonas Wind,dk DEN,FW,Wolfsburg,de Bundesliga,24-361,1999,18.5,7,5,2,3,2,4,9,44.4,5,8,3,5,2,9,15,0,Matches
2509,Florian Wirtz,de GER,MF,Leverkusen,de Bundesliga,20-276,2003,16.3,15,12,6,5,4,5,18,27.8,13,17,1,16,5,20,2,0,Matches
2510,Yoane Wissa,cd COD,FW,Brentford,eng Premier League,27-153,1996,17.2,17,11,6,7,4,1,12,8.3,11,13,2,11,6,23,9,0,Matches
2511,Axel Witsel,be BEL,DF,Atlético Madrid,es La Liga,35-022,1989,19.6,21,11,13,8,0,11,15,73.3,4,29,18,11,8,29,78,0,Matches
2512,Maximilian Wittek,de GER,"DF,MF",Bochum,de Bundesliga,28-166,1995,6.7,15,10,6,9,0,8,14,57.1,6,7,1,6,16,31,17,0,Matches
2513,Maximilian Wöber,at AUT,DF,M'Gladbach,de Bundesliga,25-364,1998,14.7,34,17,21,12,1,13,23,56.5,10,31,18,13,28,62,74,0,Matches
2514,Marius Wolf,de GER,DF,Dortmund,de Bundesliga,28-252,1995,7.4,12,7,4,7,1,6,13,46.2,7,6,0,6,5,17,10,0,Matches
2515,Nick Woltemade,de GER,"FW,MF",Werder Bremen,de Bundesliga,21-354,2002,3.9,12,9,2,9,1,8,9,88.9,1,3,0,3,0,12,8,0,Matches
2516,Jeong Woo-yeong,kr KOR,MF,Stuttgart,de Bundesliga,24-136,1999,4.2,6,4,2,4,0,3,5,60,2,3,0,3,5,11,1,0,Matches
2517,Chris Wood,nz NZL,FW,Nott'ham Forest,eng Premier League,32-058,1991,9.7,2,2,0,1,1,1,4,25,3,7,2,5,1,3,19,0,Matches
2518,Cauley Woodrow,eng ENG,"FW,MF",Luton Town,eng Premier League,29-063,1994,1,6,4,3,2,1,5,6,83.3,1,1,0,1,0,6,1,0,Matches
2519,Christopher Wooh,cm CMR,DF,Rennes,fr Ligue 1,22-138,2001,6.1,5,4,4,1,0,0,1,0,1,9,4,5,13,18,26,0,Matches
2520,Joe Worrall,eng ENG,DF,Nott'ham Forest,eng Premier League,27-024,1997,4.9,7,5,6,1,0,3,6,50,3,5,4,1,3,10,32,1,Matches
2521,Xeber,es ESP,"FW,MF",Alavés,es La Liga,26-222,1997,3,4,4,2,2,0,2,6,33.3,4,1,0,1,1,5,2,0,Matches
2522,Granit Xhaka,ch SUI,MF,Leverkusen,de Bundesliga,31-129,1992,18.7,23,15,9,11,3,8,21,38.1,13,22,5,17,13,36,25,0,Matches
2523,Abduqodir Xusanov,uz UZB,DF,Lens,fr Ligue 1,19-339,2004,4.5,7,4,5,2,0,4,12,33.3,8,9,5,4,3,10,15,2,Matches
2524,Antal Yaakobishvili,hu HUN,DF,Girona,es La Liga,19-206,2004,0.7,2,1,1,1,0,1,1,100,0,0,0,0,3,5,3,0,Matches
2525,Lamine Yamal,es ESP,FW,Barcelona,es La Liga,16-205,2007,11.9,32,21,16,8,8,11,24,45.8,13,17,0,17,10,42,8,0,Matches
2526,Roman Yaremchuk,ua UKR,FW,Valencia,es La Liga,28-068,1995,4.8,4,2,1,2,1,2,4,50,2,1,0,1,0,4,5,0,Matches
2527,Yehor Yarmoliuk,ua UKR,MF,Brentford,eng Premier League,19-339,2004,4.3,,8,,,,,,,,,,,3,,,,Matches
2528,Ryan Yates,eng ENG,MF,Nott'ham Forest,eng Premier League,26-074,1997,10.9,36,20,22,10,4,7,17,41.2,10,26,8,18,11,47,22,0,Matches
2529,Yusuf Yazıcı,tr TUR,"MF,FW",Lille,fr Ligue 1,27-005,1997,10,16,10,6,6,4,3,11,27.3,8,9,1,8,3,19,4,0,Matches
2530,Kelvin Yeboah,it ITA,FW,Montpellier,fr Ligue 1,23-273,2000,3.1,4,2,2,2,0,1,3,33.3,2,3,2,1,1,5,3,0,Matches
2531,Kenan Yıldız,tr TUR,FW,Juventus,it Serie A,18-275,2005,4.1,5,3,2,2,1,1,3,33.3,2,2,0,2,0,5,0,0,Matches
2532,Darlin Yongwa,cm CMR,DF,Lorient,fr Ligue 1,23-134,2000,7.8,18,15,10,7,1,8,13,61.5,5,8,1,7,11,29,21,0,Matches
2533,Leny Yoro,fr FRA,DF,Lille,fr Ligue 1,18-082,2005,16.6,22,16,17,3,2,11,18,61.1,7,9,4,5,26,48,58,1,Matches
2534,Ashley Young,eng ENG,"DF,MF",Everton,eng Premier League,38-209,1985,14.3,25,18,13,9,3,14,31,45.2,17,12,4,8,14,39,28,2,Matches
2535,Etienne Youte Kinkoue,fr FRA,DF,Le Havre,fr Ligue 1,22-020,2002,10,6,5,6,0,0,4,7,57.1,3,7,4,3,20,26,55,0,Matches
2536,Illia Zabarnyi,ua UKR,DF,Bournemouth,eng Premier League,21-155,2002,21,31,19,16,14,1,11,27,40.7,16,31,22,9,21,52,79,3,Matches
2537,Mattia Zaccagni,it ITA,FW,Lazio,it Serie A,28-232,1995,14.3,17,14,8,9,0,4,10,40,6,17,2,15,14,31,8,0,Matches
2538,Dan-Axel Zagadou,fr FRA,DF,Stuttgart,de Bundesliga,24-245,1999,16.1,21,14,16,5,0,4,8,50,4,23,18,5,20,41,78,1,Matches
2539,Warren Zaire-Emery,fr FRA,"MF,DF",Paris S-G,fr Ligue 1,17-332,2006,15.4,33,17,9,16,8,20,35,57.1,15,22,6,16,14,47,14,1,Matches
2540,Denis Zakaria,ch SUI,"MF,DF",Monaco,fr Ligue 1,27-075,1996,15,27,19,9,13,5,9,20,45,11,29,10,19,31,58,29,0,Matches
2541,Arsen Zakharyan,ru RUS,"MF,FW",Real Sociedad,es La Liga,20-253,2003,5.8,10,7,5,5,0,5,11,45.5,6,12,0,12,1,11,6,0,Matches
2542,Joseba Zaldúa,es ESP,DF,Cádiz,es La Liga,31-224,1992,3.1,11,7,9,1,1,6,9,66.7,3,3,3,0,1,12,10,0,Matches
2543,Nicola Zalewski,pl POL,DF,Roma,it Serie A,22-011,2002,7.1,15,11,6,8,1,6,17,35.3,11,9,3,6,6,21,13,0,Matches
2544,Andre-Frank Zambo Anguissa,cm CMR,MF,Napoli,it Serie A,28-079,1995,14.3,28,12,8,15,5,14,34,41.2,20,19,2,17,20,48,10,0,Matches
2545,Nicolò Zaniolo,it ITA,"MF,FW",Aston Villa,eng Premier League,24-216,1999,5.9,11,4,6,3,2,5,11,45.5,6,12,0,12,1,12,8,0,Matches
2546,Alessandro Zanoli,it ITA,"DF,MF",Salernitana,it Serie A,23-123,2000,0.3,2,2,1,1,0,1,1,100,0,1,0,1,0,2,0,0,Matches
2547,Alessandro Zanoli,it ITA,"DF,FW",Napoli,it Serie A,23-123,2000,0.6,1,1,1,0,0,0,0,,0,0,0,0,1,2,1,0,Matches
2548,Duván Zapata,co COL,FW,Torino,it Serie A,32-308,1991,15.9,7,3,4,1,2,0,4,0,4,7,2,5,3,10,8,0,Matches
2549,Duván Zapata,co COL,FW,Atalanta,it Serie A,32-308,1991,1.2,0,0,0,0,0,0,1,0,1,0,0,0,0,0,1,0,Matches
2550,Gabriele Zappa,it ITA,DF,Cagliari,it Serie A,24-043,1999,17.2,28,16,16,9,3,19,27,70.4,8,14,1,13,12,40,48,1,Matches
2551,Davide Zappacosta,it ITA,"DF,MF",Atalanta,it Serie A,31-237,1992,11.2,12,11,4,4,4,8,17,47.1,9,13,2,11,2,14,12,0,Matches
2552,Bryan Zaragoza,es ESP,"MF,FW",Granada,es La Liga,22-284,2001,18.2,18,9,8,6,4,8,23,34.8,15,9,0,9,3,21,3,0,Matches
2553,Anass Zaroury,ma MAR,"FW,MF",Burnley,eng Premier League,23-088,2000,1.7,1,0,1,0,0,0,4,0,4,2,0,2,0,1,1,1,Matches
2554,Oier Zarraga,es ESP,"MF,DF",Udinese,it Serie A,25-030,1999,1.2,1,1,0,1,0,0,2,0,2,2,1,1,2,3,6,1,Matches
2555,Mehdi Zeffane,dz ALG,DF,Clermont Foot,fr Ligue 1,31-260,1992,7.9,14,11,9,3,2,5,16,31.3,11,4,1,3,9,23,17,0,Matches
2556,Jordan Zemura,zw ZIM,DF,Udinese,it Serie A,24-081,1999,7.4,21,14,12,7,2,9,16,56.3,7,5,1,4,9,30,9,0,Matches
2557,Robin Zentner,de GER,GK,Mainz 05,de Bundesliga,29-098,1994,14,1,1,1,0,0,1,3,33.3,2,0,0,0,0,1,7,0,Matches
2558,Alessio Zerbin,it ITA,"DF,MF",Monza,it Serie A,24-337,1999,0.2,2,1,2,0,0,0,0,,0,1,1,0,0,2,2,0,Matches
2559,Alessio Zerbin,it ITA,"FW,DF",Napoli,it Serie A,24-337,1999,1.7,5,2,1,3,1,2,7,28.6,5,1,0,1,0,5,0,0,Matches
2560,Kevin Zeroli,it ITA,MF,Milan,it Serie A,19-023,2005,0.2,0,0,0,0,0,0,0,,0,0,0,0,0,0,0,0,Matches
2561,Cedric Zesiger,ch SUI,DF,Wolfsburg,de Bundesliga,25-224,1998,10.4,7,2,5,2,0,6,11,54.5,5,20,11,9,9,16,46,1,Matches
2562,Michael Zetterer,de GER,GK,Werder Bremen,de Bundesliga,28-206,1995,12,1,0,1,0,0,1,1,100,0,0,0,0,0,1,4,2,Matches
2563,Nathan Zeze,fr FRA,DF,Nantes,fr Ligue 1,18-230,2005,2,0,0,0,0,0,0,0,,0,0,0,0,2,2,6,0,Matches
2564,Edon Zhegrova,xk KVX,FW,Lille,fr Ligue 1,24-309,1999,14.8,11,6,2,5,4,5,13,38.5,8,10,0,10,3,14,5,0,Matches
2565,Piotr Zieliński,pl POL,MF,Napoli,it Serie A,29-259,1994,15.4,18,13,4,10,4,10,20,50,10,9,1,8,8,26,13,0,Matches
2566,David Zima,cz CZE,DF,Torino,it Serie A,23-087,2000,1,1,1,1,0,0,0,0,,0,0,0,0,3,4,7,0,Matches
2567,Christoph Zimmermann,de GER,DF,Darmstadt 98,de Bundesliga,31-022,1993,5.8,18,13,14,4,0,12,18,66.7,6,11,9,2,10,28,28,1,Matches
2568,Oleksandr Zinchenko,ua UKR,DF,Arsenal,eng Premier League,27-050,1996,15.4,44,27,17,21,6,32,47,68.1,15,16,3,13,14,58,16,2,Matches
2569,Joshua Zirkzee,nl NED,FW,Bologna,it Serie A,22-257,2001,18.7,19,13,5,10,4,9,17,52.9,8,9,0,9,3,22,27,0,Matches
2570,Simon Zoller,de GER,"FW,MF",Bochum,de Bundesliga,32-222,1991,0.5,0,0,0,0,0,0,0,,0,1,0,1,0,0,0,0,Matches
2571,Nadir Zortea,it ITA,DF,Frosinone,it Serie A,24-229,1999,1,1,1,0,1,0,1,3,33.3,2,0,0,0,1,2,4,0,Matches
2572,Nadir Zortea,it ITA,DF,Atalanta,it Serie A,24-229,1999,1.7,5,4,3,1,1,1,4,25,3,2,0,2,1,6,3,0,Matches
2573,Kurt Zouma,fr FRA,DF,West Ham,eng Premier League,29-099,1994,17.7,10,8,6,4,0,2,5,40,3,22,14,8,19,29,90,0,Matches
2574,Igor Zubeldia,es ESP,DF,Real Sociedad,es La Liga,26-310,1997,19.3,26,19,19,7,0,15,21,71.4,6,21,14,7,27,53,77,1,Matches
2575,Martín Zubimendi,es ESP,MF,Real Sociedad,es La Liga,25-001,1999,19.9,37,19,12,23,2,16,30,53.3,14,22,5,17,24,61,37,0,Matches
2576,Szymon Żurkowski,pl POL,MF,Empoli,it Serie A,26-131,1997,2.4,9,3,4,4,1,2,4,50,2,1,0,1,2,11,3,0,Matches
2577,Lovro Zvonarek,hr CRO,MF,Bayern Munich,de Bundesliga,18-271,2005,0,0,0,0,0,0,0,0,,0,0,0,0,0,0,1,0,Matches
2578,Martin Ødegaard,no NOR,MF,Arsenal,eng Premier League,25-048,1998,18.7,28,10,7,15,6,10,33,30.3,23,12,1,11,5,33,4,0,Matches
2579,Milan Đurić,ba BIH,FW,Hellas Verona,it Serie A,33-257,1990,13.4,1,0,0,0,1,0,3,0,3,0,0,0,1,2,13,0,Matches
2580,Milan Đurić,ba BIH,FW,Monza,it Serie A,33-257,1990,0.4,0,0,0,0,0,0,0,,0,1,0,1,0,0,0,0,Matches
2581,Mateusz Łęgowski,pl POL,MF,Salernitana,it Serie A,21-005,2003,9.8,15,8,5,9,1,9,23,39.1,14,8,1,7,4,19,13,0,Matches